id,Any,Municipi,Altitud(m),Superfície municipi(km2),Comarca,tipus,Capital comarca,municipis/comarca,Província,H0-14,H15-64,H65-X,D0-14,D15-64,D65-X,T0-14,T15-64,T65-X,Població municipi,THomes,TDones,HShare,DShare,T0-14Share,T15-64Share,T65-XShare,Densitat (població/km2)
0,2019,Abella de la Conca,956,78.27,Pallars Jussà,Pre-Pirineu,Tremp,14,Lleida,10,64,22,9,53,21,19,117,43,179,96,83,0.5363,0.4637,0.1061,0.6536,0.2402,2.29
1,2019,Abrera,105,19.94,Baix Llobregat,Costal,St. Feliu de Llobregat,30,Barcelona,1205,4243,878,1105,4054,1004,2310,8297,1882,12489,6326,6163,0.5065,0.4935,0.185,0.6643,0.1507,626.33
2,2019,Àger,642,160.57,Noguera,Interior,Balaguer,30,Lleida,25,208,87,24,155,89,49,363,176,588,320,268,0.5442,0.4558,0.0833,0.6173,0.2993,3.66
3,2019,Agramunt,337,79.65,Urgell,Interior,Tàrrega,20,Lleida,412,1806,471,426,1660,596,838,3466,1067,5371,2689,2682,0.5007,0.4993,0.156,0.6453,0.1987,67.43
4,2019,Aguilar de Segarra,480,43.32,Bages,Interior,Manresa,30,Barcelona,27,98,30,27,82,24,54,180,54,288,155,133,0.5382,0.4618,0.1875,0.625,0.1875,6.65
5,2019,Agullana,166,27.73,Alt Empordà,Costal,Figueres,68,Girona,57,266,88,70,257,93,127,523,181,831,411,420,0.4946,0.5054,0.1528,0.6294,0.2178,29.97
6,2019,Aiguafreda,404,7.9,Vallès Oriental,Interior,Granollers,39,Barcelona,165,812,231,178,790,328,343,1602,559,2504,1208,1296,0.4824,0.5176,0.137,0.6398,0.2232,316.96
7,2019,Aiguamúrcia,314,72.95,Alt Camp,Interior,Valls,23,Tarragona,59,303,103,71,271,94,130,574,197,901,465,436,0.5161,0.4839,0.1443,0.6371,0.2186,12.35
8,2019,Aiguaviva,169,13.92,Gironès,Interior,Girona,27,Girona,73,250,60,75,240,58,148,490,118,756,383,373,0.5066,0.4934,0.1958,0.6481,0.1561,54.31
9,2019,Aitona,110,66.9,Segrià,Costal,Lleida,38,Lleida,211,890,257,179,723,331,390,1613,588,2591,1358,1233,0.5241,0.4759,0.1505,0.6225,0.2269,38.73
10,2019,"Alamús, els",212,20.53,Segrià,Costal,Lleida,38,Lleida,56,270,86,60,262,85,116,532,171,819,412,407,0.5031,0.4969,0.1416,0.6496,0.2088,39.89
11,2019,Alàs i Cerc,768,57.67,Alt Urgell,Pirineu,"Seu d'Urgell, la",19,Lleida,20,104,47,19,85,54,39,189,101,329,171,158,0.5198,0.4802,0.1185,0.5745,0.307,5.7
12,2019,"Albagés, l'",372,25.7,Garrigues,Interior,"Borges Blanques, les",24,Lleida,17,124,53,15,104,56,32,228,109,369,194,175,0.5257,0.4743,0.0867,0.6179,0.2954,14.36
13,2019,Albanyà,239,94.39,Alt Empordà,Costal,Figueres,68,Girona,15,52,13,19,47,11,34,99,24,157,80,77,0.5096,0.4904,0.2166,0.6306,0.1529,1.66
14,2019,Albatàrrec,147,10.46,Segrià,Costal,Lleida,38,Lleida,190,846,114,182,737,152,372,1583,266,2221,1150,1071,0.5178,0.4822,0.1675,0.7127,0.1198,212.33
15,2019,Albesa,237,37.61,Noguera,Interior,Balaguer,30,Lleida,117,573,165,94,416,191,211,989,356,1556,855,701,0.5495,0.4505,0.1356,0.6356,0.2288,41.37
16,2019,"Albi, l'",526,32.54,Garrigues,Interior,"Borges Blanques, les",24,Lleida,62,221,106,46,207,122,108,428,228,764,389,375,0.5092,0.4908,0.1414,0.5602,0.2984,23.48
17,2019,Albinyana,198,19.37,Baix Penedès,Costal,"Vendrell, el",14,Tarragona,186,826,231,167,773,255,353,1599,486,2438,1243,1195,0.5098,0.4902,0.1448,0.6559,0.1993,125.86
18,2019,"Albiol, l'",823,20.34,Baix Camp,Costal,Reus,28,Tarragona,50,166,37,40,159,33,90,325,70,485,253,232,0.5216,0.4784,0.1856,0.6701,0.1443,23.84
19,2019,Albons,25,11.13,Baix Empordà,Costal,"Bisbal d'Empordà, la",36,Girona,55,275,71,57,247,71,112,522,142,776,401,375,0.5168,0.4832,0.1443,0.6727,0.183,69.72
20,2019,Alcanar,72,47.07,Montsià,Costal,Amposta,12,Tarragona,677,3139,932,639,2970,1061,1316,6109,1993,9418,4748,4670,0.5041,0.4959,0.1397,0.6487,0.2116,200.08
21,2019,Alcanó,214,21.03,Segrià,Costal,Lleida,38,Lleida,19,69,31,12,69,35,31,138,66,235,119,116,0.5064,0.4936,0.1319,0.5872,0.2809,11.17
22,2019,Alcarràs,137,114.29,Segrià,Costal,Lleida,38,Lleida,930,3511,516,833,3085,639,1763,6596,1155,9514,4957,4557,0.521,0.479,0.1853,0.6933,0.1214,83.24
23,2019,Alcoletge,213,16.7,Segrià,Costal,Lleida,38,Lleida,292,1269,214,311,1106,228,603,2375,442,3420,1775,1645,0.519,0.481,0.1763,0.6944,0.1292,204.79
24,2019,Alcover,243,46.0,Alt Camp,Interior,Valls,23,Tarragona,412,1683,404,442,1622,501,854,3305,905,5064,2499,2565,0.4935,0.5065,0.1686,0.6526,0.1787,110.09
25,2019,"Aldea, l'",9,35.21,Baix Ebre,Costal,Tortosa,14,Tarragona,336,1428,433,276,1216,471,612,2644,904,4160,2197,1963,0.5281,0.4719,0.1471,0.6356,0.2173,118.15
26,2019,Aldover,14,20.2,Baix Ebre,Costal,Tortosa,14,Tarragona,58,270,117,41,252,144,99,522,261,882,445,437,0.5045,0.4955,0.1122,0.5918,0.2959,43.66
27,2019,"Aleixar, l'",262,26.1,Baix Camp,Costal,Reus,28,Tarragona,63,315,72,66,272,85,129,587,157,873,450,423,0.5155,0.4845,0.1478,0.6724,0.1798,33.45
28,2019,Alella,90,9.58,Maresme,Costal,Mataró,30,Barcelona,814,3015,933,745,3214,1080,1559,6229,2013,9801,4762,5039,0.4859,0.5141,0.1591,0.6355,0.2054,1023.07
29,2019,Alfara de Carles,334,63.87,Baix Ebre,Costal,Tortosa,14,Tarragona,15,130,54,18,101,59,33,231,113,377,199,178,0.5279,0.4721,0.0875,0.6127,0.2997,5.9
30,2019,Alfarràs,281,11.4,Segrià,Costal,Lleida,38,Lleida,176,974,309,183,796,359,359,1770,668,2797,1459,1338,0.5216,0.4784,0.1284,0.6328,0.2388,245.35
31,2019,Alfés,236,31.94,Segrià,Costal,Lleida,38,Lleida,23,99,40,17,90,43,40,189,83,312,162,150,0.5192,0.4808,0.1282,0.6058,0.266,9.77
32,2019,Alforja,374,38.24,Baix Camp,Costal,Reus,28,Tarragona,122,640,159,126,562,192,248,1202,351,1801,921,880,0.5114,0.4886,0.1377,0.6674,0.1949,47.1
33,2019,Algerri,345,54.32,Noguera,Interior,Balaguer,30,Lleida,19,122,65,11,90,79,30,212,144,386,206,180,0.5337,0.4663,0.0777,0.5492,0.3731,7.11
34,2019,Alguaire,304,50.11,Segrià,Costal,Lleida,38,Lleida,197,1077,288,222,849,338,419,1926,626,2971,1562,1409,0.5257,0.4743,0.141,0.6483,0.2107,59.29
35,2019,Alins,1048,183.19,Pallars Sobirà,Pirineu,Sort,15,Lleida,17,80,47,13,81,38,30,161,85,276,144,132,0.5217,0.4783,0.1087,0.5833,0.308,1.51
36,2019,Alió,263,7.25,Alt Camp,Interior,Valls,23,Tarragona,27,124,57,42,148,41,69,272,98,439,208,231,0.4738,0.5262,0.1572,0.6196,0.2232,60.55
37,2019,Almacelles,247,49.03,Segrià,Costal,Lleida,38,Lleida,500,2490,594,464,2004,739,964,4494,1333,6791,3584,3207,0.5278,0.4722,0.142,0.6618,0.1963,138.51
38,2019,Almatret,462,56.83,Segrià,Costal,Lleida,38,Lleida,5,113,54,2,72,61,7,185,115,307,172,135,0.5603,0.4397,0.0228,0.6026,0.3746,5.4
39,2019,Almenar,329,66.59,Segrià,Costal,Lleida,38,Lleida,238,1197,356,205,975,427,443,2172,783,3398,1791,1607,0.5271,0.4729,0.1304,0.6392,0.2304,51.03
40,2019,Almoster,290,5.96,Baix Camp,Costal,Reus,28,Tarragona,91,494,95,89,482,100,180,976,195,1351,680,671,0.5033,0.4967,0.1332,0.7224,0.1443,226.68
41,2019,Alòs de Balaguer,297,69.08,Noguera,Interior,Balaguer,30,Lleida,6,42,26,5,28,23,11,70,49,130,74,56,0.5692,0.4308,0.0846,0.5385,0.3769,1.88
42,2019,Alp,1158,44.29,Cerdanya,Pirineu,Puigcerdà,17,Girona,99,617,112,91,543,118,190,1160,230,1580,828,752,0.5241,0.4759,0.1203,0.7342,0.1456,35.67
43,2019,Alpens,855,13.8,Osona,Interior,Vic,50,Barcelona,21,105,18,17,81,24,38,186,42,266,144,122,0.5414,0.4586,0.1429,0.6992,0.1579,19.28
44,2019,Alpicat,264,15.33,Segrià,Costal,Lleida,38,Lleida,590,2147,397,593,2060,468,1183,4207,865,6255,3134,3121,0.501,0.499,0.1891,0.6726,0.1383,408.02
45,2019,Alt Àneu,1076,217.76,Pallars Sobirà,Pirineu,Sort,15,Lleida,22,158,51,12,121,41,34,279,92,405,231,174,0.5704,0.4296,0.084,0.6889,0.2272,1.86
46,2019,Altafulla,52,6.95,Tarragonès,Costal,Tarragona,22,Tarragona,453,1667,435,472,1726,490,925,3393,925,5243,2555,2688,0.4873,0.5127,0.1764,0.6471,0.1764,754.39
47,2019,Amer,186,40.08,Selva,Costal,Sta. Coloma de Farners,26,Girona,152,728,242,166,697,313,318,1425,555,2298,1122,1176,0.4883,0.5117,0.1384,0.6201,0.2415,57.34
48,2019,"Ametlla de Mar, l'",19,66.86,Baix Ebre,Costal,Tortosa,14,Tarragona,488,2109,787,458,2061,884,946,4170,1671,6787,3384,3403,0.4986,0.5014,0.1394,0.6144,0.2462,101.51
49,2019,"Ametlla del Vallès, l'",281,14.24,Vallès Oriental,Interior,Granollers,39,Barcelona,736,2949,592,653,2882,650,1389,5831,1242,8462,4277,4185,0.5054,0.4946,0.1641,0.6891,0.1468,594.24
50,2019,"Ampolla, l'",8,35.65,Baix Ebre,Costal,Tortosa,14,Tarragona,181,1026,424,194,938,442,375,1964,866,3205,1631,1574,0.5089,0.4911,0.117,0.6128,0.2702,89.9
51,2019,Amposta,8,138.31,Montsià,Costal,Amposta,12,Tarragona,1802,6866,1781,1584,6585,2120,3386,13451,3901,20738,10449,10289,0.5039,0.4961,0.1633,0.6486,0.1881,149.94
52,2019,Anglès,181,16.31,Selva,Costal,Sta. Coloma de Farners,26,Girona,486,1836,458,469,1759,591,955,3595,1049,5599,2780,2819,0.4965,0.5035,0.1706,0.6421,0.1874,343.29
53,2019,Anglesola,335,23.53,Urgell,Interior,Tàrrega,20,Lleida,99,439,144,123,377,181,222,816,325,1363,682,681,0.5004,0.4996,0.1629,0.5987,0.2384,57.93
54,2019,Arbeca,332,58.34,Garrigues,Interior,"Borges Blanques, les",24,Lleida,121,711,268,127,611,306,248,1322,574,2144,1100,1044,0.5131,0.4869,0.1157,0.6166,0.2677,36.75
55,2019,"Arboç, l'",166,14.13,Baix Penedès,Costal,"Vendrell, el",14,Tarragona,533,1910,409,493,1687,485,1026,3597,894,5517,2852,2665,0.5169,0.4831,0.186,0.652,0.162,390.45
56,2019,Arbolí,714,20.78,Baix Camp,Costal,Reus,28,Tarragona,7,58,14,4,37,17,11,95,31,137,79,58,0.5766,0.4234,0.0803,0.6934,0.2263,6.59
57,2019,Arbúcies,291,86.22,Selva,Costal,Sta. Coloma de Farners,26,Girona,569,2291,530,562,1956,648,1131,4247,1178,6556,3390,3166,0.5171,0.4829,0.1725,0.6478,0.1797,76.04
58,2019,Arenys de Mar,10,6.75,Maresme,Costal,Mataró,30,Barcelona,1196,5104,1383,1066,5010,2017,2262,10114,3400,15776,7683,8093,0.487,0.513,0.1434,0.6411,0.2155,2337.19
59,2019,Arenys de Munt,121,21.29,Maresme,Costal,Mataró,30,Barcelona,771,3007,705,681,2913,854,1452,5920,1559,8931,4483,4448,0.502,0.498,0.1626,0.6629,0.1746,419.49
60,2019,Argelaguer,183,12.54,Garrotxa,Pre-Pirineu,Olot,21,Girona,18,144,43,20,127,45,38,271,88,397,205,192,0.5164,0.4836,0.0957,0.6826,0.2217,31.66
61,2019,Argençola,716,47.09,Anoia,Interior,Igualada,33,Barcelona,11,81,18,16,68,23,27,149,41,217,110,107,0.5069,0.4931,0.1244,0.6866,0.1889,4.61
62,2019,"Argentera, l'",344,10.12,Baix Camp,Costal,Reus,28,Tarragona,0,51,19,4,30,20,4,81,39,124,70,54,0.5645,0.4355,0.0323,0.6532,0.3145,12.25
63,2019,Argentona,88,25.4,Maresme,Costal,Mataró,30,Barcelona,1059,4104,969,998,4089,1233,2057,8193,2202,12452,6132,6320,0.4925,0.5075,0.1652,0.658,0.1768,490.24
64,2019,"Armentera, l'",7,5.6,Alt Empordà,Costal,Figueres,68,Girona,74,299,88,85,282,102,159,581,190,930,461,469,0.4957,0.5043,0.171,0.6247,0.2043,166.07
65,2019,Arnes,506,42.97,Terra Alta,Interior,Gandesa,12,Tarragona,23,115,86,21,121,89,44,236,175,455,224,231,0.4923,0.5077,0.0967,0.5187,0.3846,10.59
66,2019,Arres,1224,11.57,Val d'Aran,Pirineu,Vielha,9,Lleida,2,33,7,3,18,2,5,51,9,65,42,23,0.6462,0.3538,0.0769,0.7846,0.1385,5.62
67,2019,Arsèguel,950,10.59,Alt Urgell,Pirineu,"Seu d'Urgell, la",19,Lleida,10,28,10,5,26,5,15,54,15,84,48,36,0.5714,0.4286,0.1786,0.6429,0.1786,7.93
68,2019,Artés,316,17.87,Bages,Interior,Manresa,30,Barcelona,464,1946,458,446,1803,581,910,3749,1039,5698,2868,2830,0.5033,0.4967,0.1597,0.658,0.1823,318.86
69,2019,Artesa de Lleida,202,23.94,Segrià,Costal,Lleida,38,Lleida,104,549,136,93,454,168,197,1003,304,1504,789,715,0.5246,0.4754,0.131,0.6669,0.2021,62.82
70,2019,Artesa de Segre,318,175.9,Noguera,Interior,Balaguer,30,Lleida,256,1156,354,237,1029,400,493,2185,754,3432,1766,1666,0.5146,0.4854,0.1436,0.6367,0.2197,19.51
71,2019,Ascó,70,73.63,Ribera d'Ebre,Interior,Móra d'Ebre,14,Tarragona,105,562,189,91,506,207,196,1068,396,1660,856,804,0.5157,0.4843,0.1181,0.6434,0.2386,22.55
72,2019,Aspa,256,10.21,Segrià,Costal,Lleida,38,Lleida,13,66,34,11,61,39,24,127,73,224,113,111,0.5045,0.4955,0.1071,0.567,0.3259,21.94
73,2019,"Avellanes i Santa Linya, les",567,102.96,Noguera,Interior,Balaguer,30,Lleida,26,149,84,26,98,66,52,247,150,449,259,190,0.5768,0.4232,0.1158,0.5501,0.3341,4.36
74,2019,Avià,677,27.23,Berguedà,Pre-Pirineu,Berga,31,Barcelona,191,716,214,160,707,238,351,1423,452,2226,1121,1105,0.5036,0.4964,0.1577,0.6393,0.2031,81.75
75,2019,Avinyó,353,63.23,Bages,Interior,Manresa,30,Barcelona,173,751,203,158,687,303,331,1438,506,2275,1127,1148,0.4954,0.5046,0.1455,0.6321,0.2224,35.98
76,2019,Avinyonet de Puigventós,70,12.3,Alt Empordà,Costal,Figueres,68,Girona,147,560,89,156,564,94,303,1124,183,1610,796,814,0.4944,0.5056,0.1882,0.6981,0.1137,130.89
77,2019,Avinyonet del Penedès,280,29.13,Alt Penedès,Interior,Vilafranca del Penedès,27,Barcelona,115,631,157,119,499,180,234,1130,337,1701,903,798,0.5309,0.4691,0.1376,0.6643,0.1981,58.39
78,2019,Badalona,6,21.18,Barcelonès,Costal,Barcelona,5,Barcelona,17695,72883,17931,16547,71832,23552,34242,144715,41483,220440,108509,111931,0.4922,0.5078,0.1553,0.6565,0.1882,10407.93
79,2019,Badia del Vallès,120,0.93,Vallès Occidental,Interior,Sabadell i Terrassa,23,Barcelona,1060,4363,1144,999,4198,1616,2059,8561,2760,13380,6567,6813,0.4908,0.5092,0.1539,0.6398,0.2063,14387.1
80,2019,Bagà,785,43.13,Berguedà,Pre-Pirineu,Berga,31,Barcelona,128,676,260,109,651,314,237,1327,574,2138,1064,1074,0.4977,0.5023,0.1109,0.6207,0.2685,49.57
81,2019,Baix Pallars,591,129.41,Pallars Sobirà,Pirineu,Sort,15,Lleida,21,121,40,20,94,39,41,215,79,335,182,153,0.5433,0.4567,0.1224,0.6418,0.2358,2.59
82,2019,Balaguer,233,57.32,Noguera,Interior,Balaguer,30,Lleida,1534,5955,1257,1421,5254,1741,2955,11209,2998,17162,8746,8416,0.5096,0.4904,0.1722,0.6531,0.1747,299.41
83,2019,Balenyà,587,17.37,Osona,Interior,Vic,50,Barcelona,318,1337,273,297,1232,364,615,2569,637,3821,1928,1893,0.5046,0.4954,0.161,0.6723,0.1667,219.98
84,2019,Balsareny,327,36.91,Bages,Interior,Manresa,30,Barcelona,182,1088,292,200,961,436,382,2049,728,3159,1562,1597,0.4945,0.5055,0.1209,0.6486,0.2305,85.59
85,2019,Banyeres del Penedès,173,12.19,Baix Penedès,Costal,"Vendrell, el",14,Tarragona,278,1077,257,277,1008,273,555,2085,530,3170,1612,1558,0.5085,0.4915,0.1751,0.6577,0.1672,260.05
86,2019,Banyoles,172,11.05,Pla de l'Estany,Interior,Banyoles,11,Girona,1844,6609,1420,1705,6306,1942,3549,12915,3362,19826,9873,9953,0.498,0.502,0.179,0.6514,0.1696,1794.21
87,2019,Barbens,283,7.56,Pla d'Urgell,Interior,Mollerussa,16,Lleida,52,312,103,52,243,116,104,555,219,878,467,411,0.5319,0.4681,0.1185,0.6321,0.2494,116.14
88,2019,Barberà de la Conca,475,26.6,Conca de Barberà,Interior,Montblanc,22,Tarragona,37,165,55,37,115,64,74,280,119,473,257,216,0.5433,0.4567,0.1564,0.592,0.2516,17.78
89,2019,Barberà del Vallès,146,8.31,Vallès Occidental,Interior,Sabadell i Terrassa,23,Barcelona,2846,11013,2441,2768,10925,3098,5614,21938,5539,33091,16300,16791,0.4926,0.5074,0.1697,0.663,0.1674,3982.07
90,2019,Barcelona,9,101.35,Barcelonès,Costal,Barcelona,5,Barcelona,105153,530511,139955,99601,551432,210110,204754,1081943,350065,1636762,775619,861143,0.4739,0.5261,0.1251,0.661,0.2139,16149.6
91,2019,"Baronia de Rialb, la",388,145.08,Noguera,Interior,Balaguer,30,Lleida,6,73,42,10,67,39,16,140,81,237,121,116,0.5105,0.4895,0.0675,0.5907,0.3418,1.63
92,2019,Bàscara,66,17.5,Alt Empordà,Costal,Figueres,68,Girona,88,342,90,70,285,129,158,627,219,1004,520,484,0.5179,0.4821,0.1574,0.6245,0.2181,57.37
93,2019,Bassella,423,70.25,Alt Urgell,Pirineu,"Seu d'Urgell, la",19,Lleida,11,68,33,10,72,30,21,140,63,224,112,112,0.5,0.5,0.0938,0.625,0.2812,3.19
94,2019,Batea,376,128.41,Terra Alta,Interior,Gandesa,12,Tarragona,132,547,265,121,520,305,253,1067,570,1890,944,946,0.4995,0.5005,0.1339,0.5646,0.3016,14.72
95,2019,Bausen,931,17.72,Val d'Aran,Pirineu,Vielha,9,Lleida,0,17,13,2,15,11,2,32,24,58,30,28,0.5172,0.4828,0.0345,0.5517,0.4138,3.27
96,2019,Begues,399,50.44,Baix Llobregat,Costal,St. Feliu de Llobregat,30,Barcelona,667,2401,460,651,2443,476,1318,4844,936,7098,3528,3570,0.497,0.503,0.1857,0.6824,0.1319,140.72
97,2019,Begur,200,20.66,Baix Empordà,Costal,"Bisbal d'Empordà, la",36,Girona,232,1342,390,245,1268,448,477,2610,838,3925,1964,1961,0.5004,0.4996,0.1215,0.665,0.2135,189.98
98,2019,Belianes,373,15.69,Urgell,Interior,Tàrrega,20,Lleida,29,157,83,24,150,82,53,307,165,525,269,256,0.5124,0.4876,0.101,0.5848,0.3143,33.46
99,2019,Bellaguarda,640,17.14,Garrigues,Interior,"Borges Blanques, les",24,Lleida,15,96,41,7,77,51,22,173,92,287,152,135,0.5296,0.4704,0.0767,0.6028,0.3206,16.74
100,2019,Bellcaire d'Empordà,35,12.64,Baix Empordà,Costal,"Bisbal d'Empordà, la",36,Girona,52,215,69,56,213,88,108,428,157,693,336,357,0.4848,0.5152,0.1558,0.6176,0.2266,54.83
101,2019,Bellcaire d'Urgell,267,31.38,Noguera,Interior,Balaguer,30,Lleida,79,403,145,77,342,184,156,745,329,1230,627,603,0.5098,0.4902,0.1268,0.6057,0.2675,39.2
102,2019,Bell-lloc d'Urgell,196,34.92,Pla d'Urgell,Interior,Mollerussa,16,Lleida,157,770,212,178,719,279,335,1489,491,2315,1139,1176,0.492,0.508,0.1447,0.6432,0.2121,66.29
103,2019,Bellmunt d'Urgell,379,5.11,Noguera,Interior,Balaguer,30,Lleida,8,61,20,12,55,29,20,116,49,185,89,96,0.4811,0.5189,0.1081,0.627,0.2649,36.2
104,2019,Bellmunt del Priorat,261,8.86,Priorat,Interior,Falset,23,Tarragona,21,88,36,8,82,45,29,170,81,280,145,135,0.5179,0.4821,0.1036,0.6071,0.2893,31.6
105,2019,Bellprat,653,30.97,Anoia,Interior,Igualada,33,Barcelona,0,24,17,1,13,9,1,37,26,64,41,23,0.6406,0.3594,0.0156,0.5781,0.4062,2.07
106,2019,Bellpuig,308,34.98,Urgell,Interior,Tàrrega,20,Lleida,377,1921,407,415,1498,515,792,3419,922,5133,2705,2428,0.527,0.473,0.1543,0.6661,0.1796,146.74
107,2019,Bellvei,108,8.27,Baix Penedès,Costal,"Vendrell, el",14,Tarragona,205,741,186,191,683,197,396,1424,383,2203,1132,1071,0.5138,0.4862,0.1798,0.6464,0.1739,266.38
108,2019,Bellver de Cerdanya,1061,98.15,Cerdanya,Pirineu,Puigcerdà,17,Girona,142,663,204,131,569,228,273,1232,432,1937,1009,928,0.5209,0.4791,0.1409,0.636,0.223,19.74
109,2019,Bellvís,207,46.7,Pla d'Urgell,Interior,Mollerussa,16,Lleida,171,735,243,136,639,331,307,1374,574,2255,1149,1106,0.5095,0.4905,0.1361,0.6093,0.2545,48.29
110,2019,Benavent de Segrià,234,7.43,Segrià,Costal,Lleida,38,Lleida,117,561,103,117,473,128,234,1034,231,1499,781,718,0.521,0.479,0.1561,0.6898,0.1541,201.75
111,2019,Benifallet,19,62.42,Baix Ebre,Costal,Tortosa,14,Tarragona,24,220,104,33,225,133,57,445,237,739,348,391,0.4709,0.5291,0.0771,0.6022,0.3207,11.84
112,2019,Benissanet,26,23.06,Ribera d'Ebre,Interior,Móra d'Ebre,14,Tarragona,68,444,134,69,302,144,137,746,278,1161,646,515,0.5564,0.4436,0.118,0.6425,0.2394,50.35
113,2019,Berga,704,22.57,Berguedà,Pre-Pirineu,Berga,31,Barcelona,1226,5356,1584,1077,5121,2130,2303,10477,3714,16494,8166,8328,0.4951,0.5049,0.1396,0.6352,0.2252,730.79
114,2019,Besalú,151,4.93,Garrotxa,Pre-Pirineu,Olot,21,Girona,200,722,248,205,792,325,405,1514,573,2492,1170,1322,0.4695,0.5305,0.1625,0.6075,0.2299,505.48
115,2019,Bescanó,102,35.92,Gironès,Interior,Girona,27,Girona,502,1649,354,461,1576,418,963,3225,772,4960,2505,2455,0.505,0.495,0.1942,0.6502,0.1556,138.08
116,2019,Beuda,338,35.91,Garrotxa,Pre-Pirineu,Olot,21,Girona,17,70,13,20,58,12,37,128,25,190,100,90,0.5263,0.4737,0.1947,0.6737,0.1316,5.29
117,2019,Bigues i Riells,307,28.64,Vallès Oriental,Interior,Granollers,39,Barcelona,801,3191,653,767,2977,703,1568,6168,1356,9092,4645,4447,0.5109,0.4891,0.1725,0.6784,0.1491,317.46
118,2019,Biosca,455,66.21,Segarra,Interior,Cervera,21,Lleida,3,62,29,6,44,32,9,106,61,176,94,82,0.5341,0.4659,0.0511,0.6023,0.3466,2.66
119,2019,"Bisbal d'Empordà, la",39,20.62,Baix Empordà,Costal,"Bisbal d'Empordà, la",36,Girona,1022,3649,775,979,3528,1021,2001,7177,1796,10974,5446,5528,0.4963,0.5037,0.1823,0.654,0.1637,532.2
120,2019,"Bisbal de Falset, la",372,14.14,Priorat,Interior,Falset,23,Tarragona,18,68,30,10,55,35,28,123,65,216,116,100,0.537,0.463,0.1296,0.5694,0.3009,15.28
121,2019,"Bisbal del Penedès, la",189,32.54,Baix Penedès,Costal,"Vendrell, el",14,Tarragona,252,1237,373,230,1071,365,482,2308,738,3528,1862,1666,0.5278,0.4722,0.1366,0.6542,0.2092,108.42
122,2019,Biure,81,10.02,Alt Empordà,Costal,Figueres,68,Girona,11,72,35,12,70,32,23,142,67,232,118,114,0.5086,0.4914,0.0991,0.6121,0.2888,23.15
123,2019,Blancafort,428,14.48,Conca de Barberà,Interior,Montblanc,22,Tarragona,22,129,47,23,111,57,45,240,104,389,198,191,0.509,0.491,0.1157,0.617,0.2674,26.86
124,2019,Blanes,13,17.66,Selva,Costal,Sta. Coloma de Farners,26,Girona,2862,13201,3293,2730,12819,4123,5592,26020,7416,39028,19356,19672,0.496,0.504,0.1433,0.6667,0.19,2209.97
125,2019,Boadella i les Escaules,82,10.78,Alt Empordà,Costal,Figueres,68,Girona,12,89,29,18,76,28,30,165,57,252,130,122,0.5159,0.4841,0.119,0.6548,0.2262,23.38
126,2019,Bolvir,1145,10.34,Cerdanya,Pirineu,Puigcerdà,17,Girona,27,132,32,16,119,43,43,251,75,369,191,178,0.5176,0.4824,0.1165,0.6802,0.2033,35.69
127,2019,Bonastre,177,24.97,Baix Penedès,Costal,"Vendrell, el",14,Tarragona,62,239,56,63,216,52,125,455,108,688,357,331,0.5189,0.4811,0.1817,0.6613,0.157,27.55
128,2019,"Bòrdes, Es",852,21.44,Val d'Aran,Pirineu,Vielha,9,Lleida,17,102,25,17,77,21,34,179,46,259,144,115,0.556,0.444,0.1313,0.6911,0.1776,12.08
129,2019,Bordils,42,7.32,Gironès,Interior,Girona,27,Girona,154,604,129,141,591,160,295,1195,289,1779,887,892,0.4986,0.5014,0.1658,0.6717,0.1625,243.03
130,2019,"Borges Blanques, les",304,61.55,Garrigues,Interior,"Borges Blanques, les",24,Lleida,478,2048,579,443,1814,725,921,3862,1304,6087,3105,2982,0.5101,0.4899,0.1513,0.6345,0.2142,98.9
131,2019,"Borges del Camp, les",238,8.24,Baix Camp,Costal,Reus,28,Tarragona,190,688,172,153,614,220,343,1302,392,2037,1050,987,0.5155,0.4845,0.1684,0.6392,0.1924,247.21
132,2019,Borrassà,73,9.45,Alt Empordà,Costal,Figueres,68,Girona,74,239,61,63,211,66,137,450,127,714,374,340,0.5238,0.4762,0.1919,0.6303,0.1779,75.56
133,2019,Borredà,854,43.45,Berguedà,Pre-Pirineu,Berga,31,Barcelona,22,171,60,16,121,55,38,292,115,445,253,192,0.5685,0.4315,0.0854,0.6562,0.2584,10.24
134,2019,Bossòst,710,28.17,Val d'Aran,Pirineu,Vielha,9,Lleida,70,382,90,81,374,112,151,756,202,1109,542,567,0.4887,0.5113,0.1362,0.6817,0.1821,39.37
135,2019,Bot,286,34.94,Terra Alta,Interior,Gandesa,12,Tarragona,28,168,99,21,148,109,49,316,208,573,295,278,0.5148,0.4852,0.0855,0.5515,0.363,16.4
136,2019,Botarell,196,11.95,Baix Camp,Costal,Reus,28,Tarragona,93,387,69,100,341,78,193,728,147,1068,549,519,0.514,0.486,0.1807,0.6816,0.1376,89.37
137,2019,Bovera,297,31.12,Garrigues,Interior,"Borges Blanques, les",24,Lleida,8,79,46,9,55,50,17,134,96,247,133,114,0.5385,0.4615,0.0688,0.5425,0.3887,7.94
138,2019,Bràfim,236,6.42,Alt Camp,Interior,Valls,23,Tarragona,73,218,66,54,191,90,127,409,156,692,357,335,0.5159,0.4841,0.1835,0.591,0.2254,107.79
139,2019,Breda,169,5.02,Selva,Costal,Sta. Coloma de Farners,26,Girona,232,1243,361,265,1190,449,497,2433,810,3740,1836,1904,0.4909,0.5091,0.1329,0.6505,0.2166,745.02
140,2019,"Bruc, el",489,47.2,Anoia,Interior,Igualada,33,Barcelona,205,758,144,174,635,134,379,1393,278,2050,1107,943,0.54,0.46,0.1849,0.6795,0.1356,43.43
141,2019,"Brull, el",843,41.03,Osona,Interior,Vic,50,Barcelona,28,99,18,23,74,21,51,173,39,263,145,118,0.5513,0.4487,0.1939,0.6578,0.1483,6.41
142,2019,Brunyola i Sant Martí Sapresa,247,36.82,Selva,Costal,Sta. Coloma de Farners,26,Girona,23,124,48,24,114,50,47,238,98,383,195,188,0.5091,0.4909,0.1227,0.6214,0.2559,10.4
143,2019,Cabacés,358,31.27,Priorat,Interior,Falset,23,Tarragona,19,97,39,26,74,43,45,171,82,298,155,143,0.5201,0.4799,0.151,0.5738,0.2752,9.53
144,2019,Cabanabona,421,14.16,Noguera,Interior,Balaguer,30,Lleida,2,28,6,2,18,19,4,46,25,75,36,39,0.48,0.52,0.0533,0.6133,0.3333,5.3
145,2019,Cabanelles,194,55.58,Alt Empordà,Costal,Figueres,68,Girona,27,103,24,19,72,34,46,175,58,279,154,125,0.552,0.448,0.1649,0.6272,0.2079,5.02
146,2019,Cabanes,26,15.02,Alt Empordà,Costal,Figueres,68,Girona,70,323,107,72,273,103,142,596,210,948,500,448,0.5274,0.4726,0.1498,0.6287,0.2215,63.12
147,2019,"Cabanyes, les",252,1.15,Alt Penedès,Interior,Vilafranca del Penedès,27,Barcelona,100,326,62,86,318,72,186,644,134,964,488,476,0.5062,0.4938,0.1929,0.668,0.139,838.26
148,2019,Cabó,768,80.33,Alt Urgell,Pirineu,"Seu d'Urgell, la",19,Lleida,2,31,16,4,24,15,6,55,31,92,49,43,0.5326,0.4674,0.0652,0.5978,0.337,1.15
149,2019,Cabra del Camp,493,26.95,Alt Camp,Interior,Valls,23,Tarragona,90,406,112,78,366,111,168,772,223,1163,608,555,0.5228,0.4772,0.1445,0.6638,0.1917,43.15
150,2019,Cabrera d'Anoia,299,17.0,Anoia,Interior,Igualada,33,Barcelona,124,544,101,90,448,103,214,992,204,1410,769,641,0.5454,0.4546,0.1518,0.7035,0.1447,82.94
151,2019,Cabrera de Mar,104,8.98,Maresme,Costal,Mataró,30,Barcelona,366,1584,398,351,1576,405,717,3160,803,4680,2348,2332,0.5017,0.4983,0.1532,0.6752,0.1716,521.16
152,2019,Cabrils,147,7.05,Maresme,Costal,Mataró,30,Barcelona,614,2547,521,619,2582,556,1233,5129,1077,7439,3682,3757,0.495,0.505,0.1657,0.6895,0.1448,1055.18
153,2019,Cadaqués,23,26.43,Alt Empordà,Costal,Figueres,68,Girona,183,929,210,198,938,254,381,1867,464,2712,1322,1390,0.4875,0.5125,0.1405,0.6884,0.1711,102.61
154,2019,Calaf,680,9.22,Anoia,Interior,Igualada,33,Barcelona,306,1140,329,292,1060,408,598,2200,737,3535,1775,1760,0.5021,0.4979,0.1692,0.6223,0.2085,383.41
155,2019,Calafell,67,20.38,Baix Penedès,Costal,"Vendrell, el",14,Tarragona,2113,8807,2442,1845,8505,2826,3958,17312,5268,26538,13362,13176,0.5035,0.4965,0.1491,0.6523,0.1985,1302.16
156,2019,Calders,552,33.09,Moianès,Interior,Moià,10,Barcelona,73,342,84,70,304,97,143,646,181,970,499,471,0.5144,0.4856,0.1474,0.666,0.1866,29.31
157,2019,Caldes d'Estrac,33,0.88,Maresme,Costal,Mataró,30,Barcelona,212,970,244,207,989,360,419,1959,604,2982,1426,1556,0.4782,0.5218,0.1405,0.6569,0.2025,3388.64
158,2019,Caldes de Malavella,84,57.33,Selva,Costal,Sta. Coloma de Farners,26,Girona,659,2589,580,641,2482,690,1300,5071,1270,7641,3828,3813,0.501,0.499,0.1701,0.6637,0.1662,133.28
159,2019,Caldes de Montbui,203,37.45,Vallès Oriental,Interior,Granollers,39,Barcelona,1454,5915,1376,1317,5676,1816,2771,11591,3192,17554,8745,8809,0.4982,0.5018,0.1579,0.6603,0.1818,468.73
160,2019,Calella,5,8.0,Maresme,Costal,Mataró,30,Barcelona,1403,6337,1599,1315,6137,2278,2718,12474,3877,19069,9339,9730,0.4897,0.5103,0.1425,0.6542,0.2033,2383.62
161,2019,Calldetenes,489,5.8,Osona,Interior,Vic,50,Barcelona,193,853,213,201,799,230,394,1652,443,2489,1259,1230,0.5058,0.4942,0.1583,0.6637,0.178,429.14
162,2019,Callús,260,12.5,Bages,Interior,Manresa,30,Barcelona,203,712,146,193,665,221,396,1377,367,2140,1061,1079,0.4958,0.5042,0.185,0.6435,0.1715,171.2
163,2019,Calonge de Segarra,688,37.15,Anoia,Interior,Igualada,33,Barcelona,9,63,20,10,51,35,19,114,55,188,92,96,0.4894,0.5106,0.1011,0.6064,0.2926,5.06
164,2019,Calonge i Sant Antoni,22,33.57,Baix Empordà,Costal,"Bisbal d'Empordà, la",36,Girona,870,3665,1036,741,3631,1149,1611,7296,2185,11092,5571,5521,0.5023,0.4977,0.1452,0.6578,0.197,330.41
165,2019,Camarasa,321,157.13,Noguera,Interior,Balaguer,30,Lleida,47,253,110,42,226,139,89,479,249,817,410,407,0.5018,0.4982,0.1089,0.5863,0.3048,5.2
166,2019,Camarles,13,25.16,Baix Ebre,Costal,Tortosa,14,Tarragona,259,1047,332,198,967,421,457,2014,753,3224,1638,1586,0.5081,0.4919,0.1417,0.6247,0.2336,128.14
167,2019,Cambrils,24,35.21,Baix Camp,Costal,Reus,28,Tarragona,3068,11032,2453,2857,11427,3061,5925,22459,5514,33898,16553,17345,0.4883,0.5117,0.1748,0.6625,0.1627,962.74
168,2019,Camós,168,15.66,Pla de l'Estany,Interior,Banyoles,11,Girona,62,206,73,46,203,103,108,409,176,693,341,352,0.4921,0.5079,0.1558,0.5902,0.254,44.25
169,2019,Campdevànol,738,32.62,Ripollès,Pirineu,Ripoll,19,Girona,206,987,373,209,961,487,415,1948,860,3223,1566,1657,0.4859,0.5141,0.1288,0.6044,0.2668,98.8
170,2019,Campelles,1303,18.64,Ripollès,Pirineu,Ripoll,19,Girona,8,43,20,6,47,15,14,90,35,139,71,68,0.5108,0.4892,0.1007,0.6475,0.2518,7.46
171,2019,Campins,321,7.29,Vallès Oriental,Interior,Granollers,39,Barcelona,35,206,36,36,175,41,71,381,77,529,277,252,0.5236,0.4764,0.1342,0.7202,0.1456,72.57
172,2019,Campllong,113,8.59,Gironès,Interior,Girona,27,Girona,61,184,27,59,179,37,120,363,64,547,272,275,0.4973,0.5027,0.2194,0.6636,0.117,63.68
173,2019,Camprodon,947,103.38,Ripollès,Pirineu,Ripoll,19,Girona,142,691,284,144,682,338,286,1373,622,2281,1117,1164,0.4897,0.5103,0.1254,0.6019,0.2727,22.06
174,2019,Canejan,906,48.32,Val d'Aran,Pirineu,Vielha,9,Lleida,3,37,17,6,34,10,9,71,27,107,57,50,0.5327,0.4673,0.0841,0.6636,0.2523,2.21
175,2019,Canet d'Adri,217,44.41,Gironès,Interior,Girona,27,Girona,66,238,67,54,219,79,120,457,146,723,371,352,0.5131,0.4869,0.166,0.6321,0.2019,16.28
176,2019,Canet de Mar,15,5.56,Maresme,Costal,Mataró,30,Barcelona,1145,4627,1296,1041,4661,1756,2186,9288,3052,14526,7068,7458,0.4866,0.5134,0.1505,0.6394,0.2101,2612.59
177,2019,"Canonja, la",50,7.32,Tarragonès,Costal,Tarragona,22,Tarragona,519,1970,403,537,1966,498,1056,3936,901,5893,2892,3001,0.4908,0.5092,0.1792,0.6679,0.1529,805.05
178,2019,Canovelles,175,6.66,Vallès Oriental,Interior,Granollers,39,Barcelona,1560,5874,1179,1455,5178,1383,3015,11052,2562,16629,8613,8016,0.518,0.482,0.1813,0.6646,0.1541,2496.85
179,2019,Cànoves i Samalús,346,29.19,Vallès Oriental,Interior,Granollers,39,Barcelona,270,1053,258,252,1008,276,522,2061,534,3117,1581,1536,0.5072,0.4928,0.1675,0.6612,0.1713,106.78
180,2019,Cantallops,200,19.62,Alt Empordà,Costal,Figueres,68,Girona,20,95,38,24,95,41,44,190,79,313,153,160,0.4888,0.5112,0.1406,0.607,0.2524,15.95
181,2019,Canyelles,142,14.23,Garraf,Costal,Vilanova i la Geltrú,6,Barcelona,408,1652,354,369,1528,336,777,3180,690,4647,2414,2233,0.5195,0.4805,0.1672,0.6843,0.1485,326.56
182,2019,Capafonts,751,13.35,Baix Camp,Costal,Reus,28,Tarragona,4,41,17,7,37,15,11,78,32,121,62,59,0.5124,0.4876,0.0909,0.6446,0.2645,9.06
183,2019,Capçanes,223,22.49,Priorat,Interior,Falset,23,Tarragona,16,127,59,24,115,57,40,242,116,398,202,196,0.5075,0.4925,0.1005,0.608,0.2915,17.7
184,2019,Capellades,317,2.94,Anoia,Interior,Igualada,33,Barcelona,398,1724,514,382,1648,627,780,3372,1141,5293,2636,2657,0.498,0.502,0.1474,0.6371,0.2156,1800.34
185,2019,Capmany,107,26.4,Alt Empordà,Costal,Figueres,68,Girona,42,199,66,48,187,71,90,386,137,613,307,306,0.5008,0.4992,0.1468,0.6297,0.2235,23.22
186,2019,Capolat,1279,34.13,Berguedà,Pre-Pirineu,Berga,31,Barcelona,12,25,7,9,31,10,21,56,17,94,44,50,0.4681,0.5319,0.2234,0.5957,0.1809,2.75
187,2019,Cardedeu,193,12.1,Vallès Oriental,Interior,Granollers,39,Barcelona,1714,5993,1250,1657,6101,1642,3371,12094,2892,18357,8957,9400,0.4879,0.5121,0.1836,0.6588,0.1575,1517.11
188,2019,Cardona,507,66.7,Bages,Interior,Manresa,30,Barcelona,287,1443,543,303,1333,727,590,2776,1270,4636,2273,2363,0.4903,0.5097,0.1273,0.5988,0.2739,69.51
189,2019,Carme,351,11.68,Anoia,Interior,Igualada,33,Barcelona,60,255,81,50,229,90,110,484,171,765,396,369,0.5176,0.4824,0.1438,0.6327,0.2235,65.5
190,2019,Caseres,324,42.9,Terra Alta,Interior,Gandesa,12,Tarragona,6,76,47,13,72,45,19,148,92,259,129,130,0.4981,0.5019,0.0734,0.5714,0.3552,6.04
191,2019,Cassà de la Selva,137,45.21,Gironès,Interior,Girona,27,Girona,921,3658,722,862,3256,961,1783,6914,1683,10380,5301,5079,0.5107,0.4893,0.1718,0.6661,0.1621,229.6
192,2019,Casserres,611,29.46,Berguedà,Pre-Pirineu,Berga,31,Barcelona,119,503,191,105,463,227,224,966,418,1608,813,795,0.5056,0.4944,0.1393,0.6007,0.26,54.58
193,2019,Castell de l'Areny,954,24.35,Berguedà,Pre-Pirineu,Berga,31,Barcelona,4,25,9,2,27,1,6,52,10,68,38,30,0.5588,0.4412,0.0882,0.7647,0.1471,2.79
194,2019,Castell de Mur,532,62.42,Pallars Jussà,Pre-Pirineu,Tremp,14,Lleida,10,59,35,6,46,27,16,105,62,183,104,79,0.5683,0.4317,0.0874,0.5738,0.3388,2.93
195,2019,Castellar de la Ribera,657,60.19,Solsonès,Pre-Pirineu,Solsona,15,Lleida,17,35,15,10,39,18,27,74,33,134,67,67,0.5,0.5,0.2015,0.5522,0.2463,2.23
196,2019,Castellar de n'Hug,1395,47.12,Berguedà,Pre-Pirineu,Berga,31,Barcelona,4,66,15,8,45,21,12,111,36,159,85,74,0.5346,0.4654,0.0755,0.6981,0.2264,3.37
197,2019,Castellar del Riu,920,32.74,Berguedà,Pre-Pirineu,Berga,31,Barcelona,14,59,21,13,43,19,27,102,40,169,94,75,0.5562,0.4438,0.1598,0.6036,0.2367,5.16
198,2019,Castellar del Vallès,331,44.91,Vallès Occidental,Interior,Sabadell i Terrassa,23,Barcelona,2123,8092,1733,1921,8126,2192,4044,16218,3925,24187,11948,12239,0.494,0.506,0.1672,0.6705,0.1623,538.57
199,2019,Castellbell i el Vilar,178,28.47,Bages,Interior,Manresa,30,Barcelona,260,1277,326,283,1126,375,543,2403,701,3647,1863,1784,0.5108,0.4892,0.1489,0.6589,0.1922,128.1
200,2019,Castellbisbal,132,31.03,Vallès Occidental,Interior,Sabadell i Terrassa,23,Barcelona,1147,4325,766,1119,4143,890,2266,8468,1656,12390,6238,6152,0.5035,0.4965,0.1829,0.6835,0.1337,399.29
201,2019,Castellcir,773,34.18,Moianès,Interior,Moià,10,Barcelona,68,273,51,69,240,51,137,513,102,752,392,360,0.5213,0.4787,0.1822,0.6822,0.1356,22.0
202,2019,Castelldans,353,65.1,Garrigues,Interior,"Borges Blanques, les",24,Lleida,57,347,107,59,270,120,116,617,227,960,511,449,0.5323,0.4677,0.1208,0.6427,0.2365,14.75
203,2019,Castelldefels,3,12.87,Baix Llobregat,Costal,St. Feliu de Llobregat,30,Barcelona,5689,23075,4254,5299,23040,5647,10988,46115,9901,67004,33018,33986,0.4928,0.5072,0.164,0.6882,0.1478,5206.22
204,2019,Castellet i la Gornal,137,47.48,Alt Penedès,Interior,Vilafranca del Penedès,27,Barcelona,173,796,211,171,698,243,344,1494,454,2292,1180,1112,0.5148,0.4852,0.1501,0.6518,0.1981,48.27
205,2019,Castellfollit de la Roca,296,0.73,Garrotxa,Pre-Pirineu,Olot,21,Girona,79,304,110,55,277,136,134,581,246,961,493,468,0.513,0.487,0.1394,0.6046,0.256,1316.44
206,2019,Castellfollit de Riubregós,467,26.21,Anoia,Interior,Igualada,33,Barcelona,5,58,23,6,35,24,11,93,47,151,86,65,0.5695,0.4305,0.0728,0.6159,0.3113,5.76
207,2019,Castellfollit del Boix,700,58.9,Bages,Interior,Manresa,30,Barcelona,39,144,39,33,130,51,72,274,90,436,222,214,0.5092,0.4908,0.1651,0.6284,0.2064,7.4
208,2019,Castellgalí,266,17.21,Bages,Interior,Manresa,30,Barcelona,189,695,178,165,629,206,354,1324,384,2062,1062,1000,0.515,0.485,0.1717,0.6421,0.1862,119.81
209,2019,Castellnou de Bages,469,29.16,Bages,Interior,Manresa,30,Barcelona,124,517,91,135,437,93,259,954,184,1397,732,665,0.524,0.476,0.1854,0.6829,0.1317,47.91
210,2019,Castellnou de Seana,269,16.11,Pla d'Urgell,Interior,Mollerussa,16,Lleida,44,223,94,46,175,101,90,398,195,683,361,322,0.5286,0.4714,0.1318,0.5827,0.2855,42.4
211,2019,Castelló d'Empúries,17,42.3,Alt Empordà,Costal,Figueres,68,Girona,858,3703,947,860,3514,1024,1718,7217,1971,10906,5508,5398,0.505,0.495,0.1575,0.6617,0.1807,257.83
212,2019,Castelló de Farfanya,358,52.62,Noguera,Interior,Balaguer,30,Lleida,33,186,69,29,141,78,62,327,147,536,288,248,0.5373,0.4627,0.1157,0.6101,0.2743,10.19
213,2019,Castellolí,415,25.28,Anoia,Interior,Igualada,33,Barcelona,47,207,48,81,178,58,128,385,106,619,302,317,0.4879,0.5121,0.2068,0.622,0.1712,24.49
214,2019,Castell-Platja d'Aro,5,21.75,Baix Empordà,Costal,"Bisbal d'Empordà, la",36,Girona,838,3558,961,779,3615,1109,1617,7173,2070,10860,5357,5503,0.4933,0.5067,0.1489,0.6605,0.1906,499.31
215,2019,Castellserà,267,15.84,Urgell,Interior,Tàrrega,20,Lleida,58,325,123,61,274,162,119,599,285,1003,506,497,0.5045,0.4955,0.1186,0.5972,0.2841,63.32
216,2019,Castellterçol,726,31.9,Moianès,Interior,Moià,10,Barcelona,167,822,247,171,728,328,338,1550,575,2463,1236,1227,0.5018,0.4982,0.1372,0.6293,0.2335,77.21
217,2019,Castellvell del Camp,219,5.21,Baix Camp,Costal,Reus,28,Tarragona,266,966,206,217,1003,199,483,1969,405,2857,1438,1419,0.5033,0.4967,0.1691,0.6892,0.1418,548.37
218,2019,Castellví de la Marca,198,28.4,Alt Penedès,Interior,Vilafranca del Penedès,27,Barcelona,105,508,158,107,478,179,212,986,337,1535,771,764,0.5023,0.4977,0.1381,0.6423,0.2195,54.05
219,2019,Castellví de Rosanes,178,16.38,Baix Llobregat,Costal,St. Feliu de Llobregat,30,Barcelona,139,670,122,159,632,162,298,1302,284,1884,931,953,0.4942,0.5058,0.1582,0.6911,0.1507,115.02
220,2019,"Catllar, el",59,26.43,Tarragonès,Costal,Tarragona,22,Tarragona,395,1577,337,355,1471,316,750,3048,653,4451,2309,2142,0.5188,0.4812,0.1685,0.6848,0.1467,168.41
221,2019,Cava,1335,42.19,Alt Urgell,Pirineu,"Seu d'Urgell, la",19,Lleida,2,19,8,1,8,9,3,27,17,47,29,18,0.617,0.383,0.0638,0.5745,0.3617,1.11
222,2019,"Cellera de Ter, la",166,14.63,Selva,Costal,Sta. Coloma de Farners,26,Girona,152,610,203,140,591,250,292,1201,453,1946,965,981,0.4959,0.5041,0.1501,0.6172,0.2328,133.01
223,2019,Celrà,71,19.53,Gironès,Interior,Girona,27,Girona,580,1883,259,578,1849,303,1158,3732,562,5452,2722,2730,0.4993,0.5007,0.2124,0.6845,0.1031,279.16
224,2019,Centelles,496,15.18,Osona,Interior,Vic,50,Barcelona,605,2429,596,572,2355,847,1177,4784,1443,7404,3630,3774,0.4903,0.5097,0.159,0.6461,0.1949,487.75
225,2019,Cercs,650,47.35,Berguedà,Pre-Pirineu,Berga,31,Barcelona,65,379,133,55,316,197,120,695,330,1145,577,568,0.5039,0.4961,0.1048,0.607,0.2882,24.18
226,2019,Cerdanyola del Vallès,82,30.56,Vallès Occidental,Interior,Sabadell i Terrassa,23,Barcelona,4208,18981,4849,3948,19297,6120,8156,38278,10969,57403,28038,29365,0.4884,0.5116,0.1421,0.6668,0.1911,1878.37
227,2019,Cervelló,122,24.1,Baix Llobregat,Costal,St. Feliu de Llobregat,30,Barcelona,780,3057,692,720,2947,858,1500,6004,1550,9054,4529,4525,0.5002,0.4998,0.1657,0.6631,0.1712,375.68
228,2019,Cervera,548,55.19,Segarra,Interior,Cervera,21,Lleida,804,3199,667,765,2903,842,1569,6102,1509,9180,4670,4510,0.5087,0.4913,0.1709,0.6647,0.1644,166.33
229,2019,Cervià de les Garrigues,444,34.2,Garrigues,Interior,"Borges Blanques, les",24,Lleida,26,217,93,31,171,102,57,388,195,640,336,304,0.525,0.475,0.0891,0.6062,0.3047,18.71
230,2019,Cervià de Ter,45,9.9,Gironès,Interior,Girona,27,Girona,92,311,89,81,312,83,173,623,172,968,492,476,0.5083,0.4917,0.1787,0.6436,0.1777,97.78
231,2019,Cistella,130,25.55,Alt Empordà,Costal,Figueres,68,Girona,20,85,33,22,90,32,42,175,65,282,138,144,0.4894,0.5106,0.1489,0.6206,0.2305,11.04
232,2019,Ciutadilla,519,17.03,Urgell,Interior,Tàrrega,20,Lleida,11,65,35,10,56,31,21,121,66,208,111,97,0.5337,0.4663,0.101,0.5817,0.3173,12.21
233,2019,Clariana de Cardener,500,40.78,Solsonès,Pre-Pirineu,Solsona,15,Lleida,10,58,14,10,52,13,20,110,27,157,82,75,0.5223,0.4777,0.1274,0.7006,0.172,3.85
234,2019,"Cogul, el",279,17.51,Garrigues,Interior,"Borges Blanques, les",24,Lleida,6,48,34,4,38,28,10,86,62,158,88,70,0.557,0.443,0.0633,0.5443,0.3924,9.02
235,2019,Colera,10,24.35,Alt Empordà,Costal,Figueres,68,Girona,13,144,66,21,133,71,34,277,137,448,223,225,0.4978,0.5022,0.0759,0.6183,0.3058,18.4
236,2019,Coll de Nargó,573,151.41,Alt Urgell,Pirineu,"Seu d'Urgell, la",19,Lleida,35,174,76,30,162,73,65,336,149,550,285,265,0.5182,0.4818,0.1182,0.6109,0.2709,3.63
237,2019,Collbató,388,18.07,Baix Llobregat,Costal,St. Feliu de Llobregat,30,Barcelona,450,1579,291,389,1437,320,839,3016,611,4466,2320,2146,0.5195,0.4805,0.1879,0.6753,0.1368,247.15
238,2019,Colldejou,431,14.48,Baix Camp,Costal,Reus,28,Tarragona,8,66,19,11,51,21,19,117,40,176,93,83,0.5284,0.4716,0.108,0.6648,0.2273,12.15
239,2019,Collsuspina,901,15.06,Moianès,Interior,Moià,10,Barcelona,28,112,34,34,105,29,62,217,63,342,174,168,0.5088,0.4912,0.1813,0.6345,0.1842,22.71
240,2019,Colomers,41,4.35,Baix Empordà,Costal,"Bisbal d'Empordà, la",36,Girona,9,57,21,10,53,26,19,110,47,176,87,89,0.4943,0.5057,0.108,0.625,0.267,40.46
241,2019,"Coma i la Pedra, la",1004,60.62,Solsonès,Pre-Pirineu,Solsona,15,Lleida,14,113,30,9,76,23,23,189,53,265,157,108,0.5925,0.4075,0.0868,0.7132,0.2,4.37
242,2019,Conca de Dalt,507,166.48,Pallars Jussà,Pre-Pirineu,Tremp,14,Lleida,22,123,68,25,117,63,47,240,131,418,213,205,0.5096,0.4904,0.1124,0.5742,0.3134,2.51
243,2019,Conesa,705,29.02,Conca de Barberà,Interior,Montblanc,22,Tarragona,6,30,18,1,32,16,7,62,34,103,54,49,0.5243,0.4757,0.068,0.6019,0.3301,3.55
244,2019,Constantí,81,30.87,Tarragonès,Costal,Tarragona,22,Tarragona,643,2297,458,590,2054,498,1233,4351,956,6540,3398,3142,0.5196,0.4804,0.1885,0.6653,0.1462,211.86
245,2019,Copons,432,18.66,Anoia,Interior,Igualada,33,Barcelona,25,96,31,31,89,38,56,185,69,310,152,158,0.4903,0.5097,0.1806,0.5968,0.2226,16.61
246,2019,Corbera d'Ebre,337,53.09,Terra Alta,Interior,Gandesa,12,Tarragona,72,331,128,49,289,147,121,620,275,1016,531,485,0.5226,0.4774,0.1191,0.6102,0.2707,19.14
247,2019,Corbera de Llobregat,342,18.41,Baix Llobregat,Costal,St. Feliu de Llobregat,30,Barcelona,1299,5205,945,1203,5008,1162,2502,10213,2107,14822,7449,7373,0.5026,0.4974,0.1688,0.689,0.1422,805.11
248,2019,Corbins,211,21.01,Segrià,Costal,Lleida,38,Lleida,132,532,123,100,394,163,232,926,286,1444,787,657,0.545,0.455,0.1607,0.6413,0.1981,68.73
249,2019,Corçà,43,16.29,Baix Empordà,Costal,"Bisbal d'Empordà, la",36,Girona,123,380,143,86,380,155,209,760,298,1267,646,621,0.5099,0.4901,0.165,0.5998,0.2352,77.78
250,2019,Cornellà de Llobregat,27,6.99,Baix Llobregat,Costal,St. Feliu de Llobregat,30,Barcelona,6592,28862,7491,6448,28951,10248,13040,57813,17739,88592,42945,45647,0.4848,0.5152,0.1472,0.6526,0.2002,12674.11
251,2019,Cornellà del Terri,96,27.71,Pla de l'Estany,Interior,Banyoles,11,Girona,200,761,236,194,728,245,394,1489,481,2364,1197,1167,0.5063,0.4937,0.1667,0.6299,0.2035,85.31
252,2019,Cornudella de Montsant,533,63.5,Priorat,Interior,Falset,23,Tarragona,51,354,100,53,266,117,104,620,217,941,505,436,0.5367,0.4633,0.1105,0.6589,0.2306,14.82
253,2019,Creixell,48,10.46,Tarragonès,Costal,Tarragona,22,Tarragona,278,1164,403,251,1077,469,529,2241,872,3642,1845,1797,0.5066,0.4934,0.1452,0.6153,0.2394,348.18
254,2019,Crespià,138,11.38,Pla de l'Estany,Interior,Banyoles,11,Girona,20,83,24,18,68,33,38,151,57,246,127,119,0.5163,0.4837,0.1545,0.6138,0.2317,21.62
255,2019,"Cruïlles, Monells i Sant Sadurní de l'Heura",110,99.84,Baix Empordà,Costal,"Bisbal d'Empordà, la",36,Girona,90,425,125,92,421,126,182,846,251,1279,640,639,0.5004,0.4996,0.1423,0.6615,0.1962,12.81
256,2019,Cubelles,12,13.49,Garraf,Costal,Vilanova i la Geltrú,6,Barcelona,1320,5191,1176,1243,5008,1391,2563,10199,2567,15329,7687,7642,0.5015,0.4985,0.1672,0.6653,0.1675,1136.32
257,2019,Cubells,499,39.17,Noguera,Interior,Balaguer,30,Lleida,14,115,51,15,92,56,29,207,107,343,180,163,0.5248,0.4752,0.0845,0.6035,0.312,8.76
258,2019,Cunit,10,9.74,Baix Penedès,Costal,"Vendrell, el",14,Tarragona,916,4062,1369,976,4054,1575,1892,8116,2944,12952,6347,6605,0.49,0.51,0.1461,0.6266,0.2273,1329.77
259,2019,Darnius,193,34.93,Alt Empordà,Costal,Figueres,68,Girona,28,180,65,32,162,79,60,342,144,546,273,273,0.5,0.5,0.1099,0.6264,0.2637,15.63
260,2019,Das,1219,14.58,Cerdanya,Pirineu,Puigcerdà,17,Girona,21,91,19,28,71,23,49,162,42,253,131,122,0.5178,0.4822,0.1937,0.6403,0.166,17.35
261,2019,Deltebre,6,107.44,Baix Ebre,Costal,Tortosa,14,Tarragona,822,3823,1143,775,3520,1399,1597,7343,2542,11482,5788,5694,0.5041,0.4959,0.1391,0.6395,0.2214,106.87
262,2019,Dosrius,147,40.73,Maresme,Costal,Mataró,30,Barcelona,482,1958,340,476,1836,389,958,3794,729,5481,2780,2701,0.5072,0.4928,0.1748,0.6922,0.133,134.57
263,2019,Duesaigües,268,13.58,Baix Camp,Costal,Reus,28,Tarragona,14,97,29,10,65,30,24,162,59,245,140,105,0.5714,0.4286,0.098,0.6612,0.2408,18.04
264,2019,"Escala, l'",14,16.31,Alt Empordà,Costal,Figueres,68,Girona,727,3428,1112,680,3230,1162,1407,6658,2274,10339,5267,5072,0.5094,0.4906,0.1361,0.644,0.2199,633.91
265,2019,Esparreguera,187,27.4,Baix Llobregat,Costal,St. Feliu de Llobregat,30,Barcelona,1836,7754,1659,1731,7253,2018,3567,15007,3677,22251,11249,11002,0.5056,0.4944,0.1603,0.6744,0.1653,812.08
266,2019,Espinelves,752,17.43,Osona,Interior,Vic,50,Barcelona,12,79,19,16,64,25,28,143,44,215,110,105,0.5116,0.4884,0.1302,0.6651,0.2047,12.34
267,2019,"Espluga Calba, l'",434,21.53,Garrigues,Interior,"Borges Blanques, les",24,Lleida,15,103,53,18,88,64,33,191,117,341,171,170,0.5015,0.4985,0.0968,0.5601,0.3431,15.84
268,2019,"Espluga de Francolí, l'",411,56.97,Conca de Barberà,Interior,Montblanc,22,Tarragona,247,1233,344,269,1167,495,516,2400,839,3755,1824,1931,0.4858,0.5142,0.1374,0.6391,0.2234,65.91
269,2019,Esplugues de Llobregat,110,4.6,Baix Llobregat,Costal,St. Feliu de Llobregat,30,Barcelona,3416,14283,4601,3114,15175,6091,6530,29458,10692,46680,22300,24380,0.4777,0.5223,0.1399,0.6311,0.229,10147.83
270,2019,Espolla,124,43.55,Alt Empordà,Costal,Figueres,68,Girona,27,116,60,20,129,64,47,245,124,416,203,213,0.488,0.512,0.113,0.5889,0.2981,9.55
271,2019,Esponellà,142,16.06,Pla de l'Estany,Interior,Banyoles,11,Girona,41,133,50,36,122,56,77,255,106,438,224,214,0.5114,0.4886,0.1758,0.5822,0.242,27.27
272,2019,Espot,1318,97.3,Pallars Sobirà,Pirineu,Sort,15,Lleida,17,141,35,25,114,32,42,255,67,364,193,171,0.5302,0.4698,0.1154,0.7005,0.1841,3.74
273,2019,"Espunyola, l'",803,35.46,Berguedà,Pre-Pirineu,Berga,31,Barcelona,14,83,29,12,80,36,26,163,65,254,126,128,0.4961,0.5039,0.1024,0.6417,0.2559,7.16
274,2019,"Esquirol, l'",693,61.8,Osona,Interior,Vic,50,Barcelona,141,723,241,141,664,271,282,1387,512,2181,1105,1076,0.5066,0.4934,0.1293,0.6359,0.2348,35.29
275,2019,Estamariu,1084,21.16,Alt Urgell,Pirineu,"Seu d'Urgell, la",19,Lleida,10,32,26,6,28,16,16,60,42,118,68,50,0.5763,0.4237,0.1356,0.5085,0.3559,5.58
276,2019,"Estany, l'",870,10.25,Moianès,Interior,Moià,10,Barcelona,33,125,47,19,111,71,52,236,118,406,205,201,0.5049,0.4951,0.1281,0.5813,0.2906,39.61
277,2019,Estaràs,596,20.99,Segarra,Interior,Cervera,21,Lleida,8,47,30,10,49,18,18,96,48,162,85,77,0.5247,0.4753,0.1111,0.5926,0.2963,7.72
278,2019,Esterri d'Àneu,957,8.49,Pallars Sobirà,Pirineu,Sort,15,Lleida,43,276,45,55,278,75,98,554,120,772,364,408,0.4715,0.5285,0.1269,0.7176,0.1554,90.93
279,2019,Esterri de Cardós,1212,16.55,Pallars Sobirà,Pirineu,Sort,15,Lleida,5,27,5,5,21,7,10,48,12,70,37,33,0.5286,0.4714,0.1429,0.6857,0.1714,4.23
280,2019,Falset,364,31.62,Priorat,Interior,Falset,23,Tarragona,234,902,276,211,867,344,445,1769,620,2834,1412,1422,0.4982,0.5018,0.157,0.6242,0.2188,89.63
281,2019,"Far d'Empordà, el",44,9.0,Alt Empordà,Costal,Figueres,68,Girona,51,205,49,51,184,59,102,389,108,599,305,294,0.5092,0.4908,0.1703,0.6494,0.1803,66.56
282,2019,Farrera,1294,61.87,Pallars Sobirà,Pirineu,Sort,15,Lleida,6,44,15,8,33,10,14,77,25,116,65,51,0.5603,0.4397,0.1207,0.6638,0.2155,1.87
283,2019,"Fatarella, la",487,56.52,Terra Alta,Interior,Gandesa,12,Tarragona,37,277,144,57,243,183,94,520,327,941,458,483,0.4867,0.5133,0.0999,0.5526,0.3475,16.65
284,2019,"Febró, la",754,16.08,Baix Camp,Costal,Reus,28,Tarragona,0,16,9,0,11,4,0,27,13,40,25,15,0.625,0.375,0.0,0.675,0.325,2.49
285,2019,Figaró-Montmany,330,14.99,Vallès Oriental,Interior,Granollers,39,Barcelona,75,379,93,85,363,119,160,742,212,1114,547,567,0.491,0.509,0.1436,0.6661,0.1903,74.32
286,2019,Fígols,1154,29.31,Berguedà,Pre-Pirineu,Berga,31,Barcelona,2,15,8,1,7,9,3,22,17,42,25,17,0.5952,0.4048,0.0714,0.5238,0.4048,1.43
287,2019,Fígols i Alinyà,602,101.8,Alt Urgell,Pirineu,"Seu d'Urgell, la",19,Lleida,12,88,45,10,62,35,22,150,80,252,145,107,0.5754,0.4246,0.0873,0.5952,0.3175,2.48
288,2019,"Figuera, la",576,18.69,Priorat,Interior,Falset,23,Tarragona,3,41,19,2,25,21,5,66,40,111,63,48,0.5676,0.4324,0.045,0.5946,0.3604,5.94
289,2019,Figueres,39,19.3,Alt Empordà,Costal,Figueres,68,Girona,4278,15825,2989,3989,15394,4179,8267,31219,7168,46654,23092,23562,0.495,0.505,0.1772,0.6692,0.1536,2417.31
290,2019,Figuerola del Camp,474,22.72,Alt Camp,Interior,Valls,23,Tarragona,23,109,27,23,99,39,46,208,66,320,159,161,0.4969,0.5031,0.1438,0.65,0.2062,14.08
291,2019,Flaçà,34,6.53,Gironès,Interior,Girona,27,Girona,84,356,88,88,343,134,172,699,222,1093,528,565,0.4831,0.5169,0.1574,0.6395,0.2031,167.38
292,2019,Flix,47,116.9,Ribera d'Ebre,Interior,Móra d'Ebre,14,Tarragona,192,1102,423,148,1010,533,340,2112,956,3408,1717,1691,0.5038,0.4962,0.0998,0.6197,0.2805,29.15
293,2019,"Floresta, la",316,5.46,Garrigues,Interior,"Borges Blanques, les",24,Lleida,3,56,20,8,37,23,11,93,43,147,79,68,0.5374,0.4626,0.0748,0.6327,0.2925,26.92
294,2019,Fogars de la Selva,45,32.12,Selva,Costal,Sta. Coloma de Farners,26,Girona,93,519,136,98,465,140,191,984,276,1451,748,703,0.5155,0.4845,0.1316,0.6782,0.1902,45.17
295,2019,Fogars de Montclús,386,39.72,Vallès Oriental,Interior,Granollers,39,Barcelona,44,158,43,47,137,41,91,295,84,470,245,225,0.5213,0.4787,0.1936,0.6277,0.1787,11.83
296,2019,Foixà,85,18.8,Baix Empordà,Costal,"Bisbal d'Empordà, la",36,Girona,14,100,36,15,80,52,29,180,88,297,150,147,0.5051,0.4949,0.0976,0.6061,0.2963,15.8
297,2019,Folgueroles,552,10.47,Osona,Interior,Vic,50,Barcelona,241,756,162,208,708,192,449,1464,354,2267,1159,1108,0.5112,0.4888,0.1981,0.6458,0.1562,216.52
298,2019,Fondarella,243,5.43,Pla d'Urgell,Interior,Mollerussa,16,Lleida,53,263,71,58,260,79,111,523,150,784,387,397,0.4936,0.5064,0.1416,0.6671,0.1913,144.38
299,2019,Fonollosa,525,51.67,Bages,Interior,Manresa,30,Barcelona,110,497,143,100,461,142,210,958,285,1453,750,703,0.5162,0.4838,0.1445,0.6593,0.1961,28.12
300,2019,Fontanals de Cerdanya,1180,28.65,Cerdanya,Pirineu,Puigcerdà,17,Girona,19,152,49,26,149,49,45,301,98,444,220,224,0.4955,0.5045,0.1014,0.6779,0.2207,15.5
301,2019,Fontanilles,29,9.28,Baix Empordà,Costal,"Bisbal d'Empordà, la",36,Girona,9,52,19,3,33,23,12,85,42,139,80,59,0.5755,0.4245,0.0863,0.6115,0.3022,14.98
302,2019,Fontcoberta,207,17.28,Pla de l'Estany,Interior,Banyoles,11,Girona,137,478,123,113,495,122,250,973,245,1468,738,730,0.5027,0.4973,0.1703,0.6628,0.1669,84.95
303,2019,Font-rubí,319,37.42,Alt Penedès,Interior,Vilafranca del Penedès,27,Barcelona,93,440,155,97,390,152,190,830,307,1327,688,639,0.5185,0.4815,0.1432,0.6255,0.2313,35.46
304,2019,Foradada,455,28.55,Noguera,Interior,Balaguer,30,Lleida,13,68,27,11,41,26,24,109,53,186,108,78,0.5806,0.4194,0.129,0.586,0.2849,6.51
305,2019,Forallac,51,50.63,Baix Empordà,Costal,"Bisbal d'Empordà, la",36,Girona,128,534,166,114,543,202,242,1077,368,1687,828,859,0.4908,0.5092,0.1434,0.6384,0.2181,33.32
306,2019,Forès,866,16.03,Conca de Barberà,Interior,Montblanc,22,Tarragona,1,13,11,1,7,10,2,20,21,43,25,18,0.5814,0.4186,0.0465,0.4651,0.4884,2.68
307,2019,Fornells de la Selva,102,11.86,Gironès,Interior,Girona,27,Girona,283,868,171,245,894,189,528,1762,360,2650,1322,1328,0.4989,0.5011,0.1992,0.6649,0.1358,223.44
308,2019,Fortià,8,10.76,Alt Empordà,Costal,Figueres,68,Girona,59,261,69,58,241,75,117,502,144,763,389,374,0.5098,0.4902,0.1533,0.6579,0.1887,70.91
309,2019,"Franqueses del Vallès, les",181,29.14,Vallès Oriental,Interior,Granollers,39,Barcelona,1962,6994,1254,1835,6606,1441,3797,13600,2695,20092,10210,9882,0.5082,0.4918,0.189,0.6769,0.1341,689.5
310,2019,Freginals,126,17.59,Montsià,Costal,Amposta,12,Tarragona,18,119,38,11,98,62,29,217,100,346,175,171,0.5058,0.4942,0.0838,0.6272,0.289,19.67
311,2019,"Fuliola, la",275,11.05,Urgell,Interior,Tàrrega,20,Lleida,99,400,120,105,355,169,204,755,289,1248,619,629,0.496,0.504,0.1635,0.605,0.2316,112.94
312,2019,Fulleda,581,16.18,Garrigues,Interior,"Borges Blanques, les",24,Lleida,0,29,15,1,24,16,1,53,31,85,44,41,0.5176,0.4824,0.0118,0.6235,0.3647,5.25
313,2019,Gaià,481,39.48,Bages,Interior,Manresa,30,Barcelona,13,67,17,15,50,13,28,117,30,175,97,78,0.5543,0.4457,0.16,0.6686,0.1714,4.43
314,2019,"Galera, la",112,27.47,Montsià,Costal,Amposta,12,Tarragona,50,240,85,38,200,118,88,440,203,731,375,356,0.513,0.487,0.1204,0.6019,0.2777,26.61
315,2019,Gallifa,502,16.33,Vallès Occidental,Interior,Sabadell i Terrassa,23,Barcelona,10,67,18,5,50,22,15,117,40,172,95,77,0.5523,0.4477,0.0872,0.6802,0.2326,10.53
316,2019,Gandesa,363,71.15,Terra Alta,Interior,Gandesa,12,Tarragona,243,997,323,212,921,368,455,1918,691,3064,1563,1501,0.5101,0.4899,0.1485,0.626,0.2255,43.06
317,2019,Garcia,73,52.37,Ribera d'Ebre,Interior,Móra d'Ebre,14,Tarragona,29,167,68,37,142,84,66,309,152,527,264,263,0.5009,0.4991,0.1252,0.5863,0.2884,10.06
318,2019,"Garidells, els",132,3.07,Alt Camp,Interior,Valls,23,Tarragona,12,64,18,10,66,17,22,130,35,187,94,93,0.5027,0.4973,0.1176,0.6952,0.1872,60.91
319,2019,"Garriga, la",252,18.8,Vallès Oriental,Interior,Granollers,39,Barcelona,1435,5382,1170,1329,5625,1573,2764,11007,2743,16514,7987,8527,0.4837,0.5163,0.1674,0.6665,0.1661,878.4
320,2019,Garrigàs,101,19.89,Alt Empordà,Costal,Figueres,68,Girona,37,152,42,29,137,40,66,289,82,437,231,206,0.5286,0.4714,0.151,0.6613,0.1876,21.97
321,2019,Garrigoles,92,9.4,Baix Empordà,Costal,"Bisbal d'Empordà, la",36,Girona,7,59,18,14,44,20,21,103,38,162,84,78,0.5185,0.4815,0.1296,0.6358,0.2346,17.23
322,2019,Garriguella,56,21.01,Alt Empordà,Costal,Figueres,68,Girona,67,261,93,71,271,92,138,532,185,855,421,434,0.4924,0.5076,0.1614,0.6222,0.2164,40.69
323,2019,Gavà,9,30.75,Baix Llobregat,Costal,St. Feliu de Llobregat,30,Barcelona,3944,15360,3572,3655,15654,4586,7599,31014,8158,46771,22876,23895,0.4891,0.5109,0.1625,0.6631,0.1744,1521.01
324,2019,Gavet de la Conca,421,90.9,Pallars Jussà,Pre-Pirineu,Tremp,14,Lleida,11,79,39,9,67,56,20,146,95,261,129,132,0.4943,0.5057,0.0766,0.5594,0.364,2.87
325,2019,Gelida,196,26.69,Alt Penedès,Interior,Vilafranca del Penedès,27,Barcelona,697,2565,516,634,2459,662,1331,5024,1178,7533,3778,3755,0.5015,0.4985,0.1767,0.6669,0.1564,282.24
326,2019,Ger,1135,33.38,Cerdanya,Pirineu,Puigcerdà,17,Girona,36,138,48,39,146,41,75,284,89,448,222,226,0.4955,0.5045,0.1674,0.6339,0.1987,13.42
327,2019,Gimenells i el Pla de la Font,258,55.84,Segrià,Costal,Lleida,38,Lleida,79,399,117,67,307,142,146,706,259,1111,595,516,0.5356,0.4644,0.1314,0.6355,0.2331,19.9
328,2019,Ginestar,26,15.84,Ribera d'Ebre,Interior,Móra d'Ebre,14,Tarragona,38,256,109,23,211,116,61,467,225,753,403,350,0.5352,0.4648,0.081,0.6202,0.2988,47.54
329,2019,Girona,70,39.12,Gironès,Interior,Girona,27,Girona,8741,33551,6639,8169,35463,9289,16910,69014,15928,101852,48931,52921,0.4804,0.5196,0.166,0.6776,0.1564,2603.58
330,2019,Gironella,469,6.78,Berguedà,Pre-Pirineu,Berga,31,Barcelona,362,1480,542,334,1404,704,696,2884,1246,4826,2384,2442,0.494,0.506,0.1442,0.5976,0.2582,711.8
331,2019,Gisclareny,1340,36.47,Berguedà,Pre-Pirineu,Berga,31,Barcelona,1,11,3,0,8,2,1,19,5,25,15,10,0.6,0.4,0.04,0.76,0.2,0.69
332,2019,Godall,168,33.62,Montsià,Costal,Amposta,12,Tarragona,24,168,97,31,153,102,55,321,199,575,289,286,0.5026,0.4974,0.0957,0.5583,0.3461,17.1
333,2019,Golmés,275,16.62,Pla d'Urgell,Interior,Mollerussa,16,Lleida,149,610,158,169,574,180,318,1184,338,1840,917,923,0.4984,0.5016,0.1728,0.6435,0.1837,110.71
334,2019,Gombrèn,919,43.26,Ripollès,Pirineu,Ripoll,19,Girona,21,58,17,14,50,28,35,108,45,188,96,92,0.5106,0.4894,0.1862,0.5745,0.2394,4.35
335,2019,Gósol,1423,56.29,Berguedà,Pre-Pirineu,Berga,31,Barcelona,9,79,30,5,51,32,14,130,62,206,118,88,0.5728,0.4272,0.068,0.6311,0.301,3.66
336,2019,"Granada, la",272,6.52,Alt Penedès,Interior,Vilafranca del Penedès,27,Barcelona,200,747,145,177,708,180,377,1455,325,2157,1092,1065,0.5063,0.4937,0.1748,0.6745,0.1507,330.83
337,2019,"Granadella, la",528,88.7,Garrigues,Interior,"Borges Blanques, les",24,Lleida,48,240,99,32,179,114,80,419,213,712,387,325,0.5435,0.4565,0.1124,0.5885,0.2992,8.03
338,2019,Granera,782,23.73,Moianès,Interior,Moià,10,Barcelona,3,38,12,0,11,5,3,49,17,69,53,16,0.7681,0.2319,0.0435,0.7101,0.2464,2.91
339,2019,"Granja d'Escarp, la",78,38.51,Segrià,Costal,Lleida,38,Lleida,46,369,99,56,237,129,102,606,228,936,514,422,0.5491,0.4509,0.109,0.6474,0.2436,24.31
340,2019,Granollers,145,14.87,Vallès Oriental,Interior,Granollers,39,Barcelona,4773,20731,4695,4514,20258,6304,9287,40989,10999,61275,30199,31076,0.4928,0.5072,0.1516,0.6689,0.1795,4120.71
341,2019,Granyanella,508,24.35,Segarra,Interior,Cervera,21,Lleida,6,50,26,5,43,18,11,93,44,148,82,66,0.5541,0.4459,0.0743,0.6284,0.2973,6.08
342,2019,Granyena de les Garrigues,366,20.47,Garrigues,Interior,"Borges Blanques, les",24,Lleida,9,48,21,5,29,20,14,77,41,132,78,54,0.5909,0.4091,0.1061,0.5833,0.3106,6.45
343,2019,Granyena de Segarra,636,16.3,Segarra,Interior,Cervera,21,Lleida,6,46,24,10,31,25,16,77,49,142,76,66,0.5352,0.4648,0.1127,0.5423,0.3451,8.71
344,2019,Gratallops,321,13.52,Priorat,Interior,Falset,23,Tarragona,8,90,27,8,58,38,16,148,65,229,125,104,0.5459,0.4541,0.0699,0.6463,0.2838,16.94
345,2019,Gualba,177,23.29,Vallès Oriental,Interior,Granollers,39,Barcelona,161,511,97,148,461,122,309,972,219,1500,769,731,0.5127,0.4873,0.206,0.648,0.146,64.41
346,2019,Gualta,15,9.02,Baix Empordà,Costal,"Bisbal d'Empordà, la",36,Girona,38,152,39,26,110,32,64,262,71,397,229,168,0.5768,0.4232,0.1612,0.6599,0.1788,44.01
347,2019,Guardiola de Berguedà,720,61.73,Berguedà,Pre-Pirineu,Berga,31,Barcelona,47,306,111,56,265,123,103,571,234,908,464,444,0.511,0.489,0.1134,0.6289,0.2577,14.71
348,2019,"Guiamets, els",226,12.14,Priorat,Interior,Falset,23,Tarragona,9,84,35,11,78,53,20,162,88,270,128,142,0.4741,0.5259,0.0741,0.6,0.3259,22.24
349,2019,Guils de Cerdanya,1385,22.02,Cerdanya,Pirineu,Puigcerdà,17,Girona,31,207,50,33,165,51,64,372,101,537,288,249,0.5363,0.4637,0.1192,0.6927,0.1881,24.39
350,2019,Guimerà,555,25.76,Urgell,Interior,Tàrrega,20,Lleida,11,86,43,17,52,56,28,138,99,265,140,125,0.5283,0.4717,0.1057,0.5208,0.3736,10.29
351,2019,"Guingueta d'Àneu, la",919,108.42,Pallars Sobirà,Pirineu,Sort,15,Lleida,15,101,43,15,87,36,30,188,79,297,159,138,0.5354,0.4646,0.101,0.633,0.266,2.74
352,2019,Guissona,484,18.1,Segarra,Interior,Cervera,21,Lleida,752,2762,296,641,2300,385,1393,5062,681,7136,3810,3326,0.5339,0.4661,0.1952,0.7094,0.0954,394.25
353,2019,Guixers,840,66.44,Solsonès,Pre-Pirineu,Solsona,15,Lleida,8,50,26,4,29,17,12,79,43,134,84,50,0.6269,0.3731,0.0896,0.5896,0.3209,2.02
354,2019,Gurb,516,51.57,Osona,Interior,Vic,50,Barcelona,243,933,210,205,862,228,448,1795,438,2681,1386,1295,0.517,0.483,0.1671,0.6695,0.1634,51.99
355,2019,Horta de Sant Joan,542,118.99,Terra Alta,Interior,Gandesa,12,Tarragona,71,367,164,60,308,179,131,675,343,1149,602,547,0.5239,0.4761,0.114,0.5875,0.2985,9.66
356,2019,"Hospitalet de Llobregat, l'",8,12.4,Barcelonès,Costal,Barcelona,5,Barcelona,19068,86539,22374,18036,88016,30890,37104,174555,53264,264923,127981,136942,0.4831,0.5169,0.1401,0.6589,0.2011,21364.76
357,2019,"Hostalets de Pierola, els",361,33.49,Anoia,Interior,Igualada,33,Barcelona,264,1064,190,264,966,225,528,2030,415,2973,1518,1455,0.5106,0.4894,0.1776,0.6828,0.1396,88.77
358,2019,Hostalric,189,3.39,Selva,Costal,Sta. Coloma de Farners,26,Girona,373,1434,323,339,1347,405,712,2781,728,4221,2130,2091,0.5046,0.4954,0.1687,0.6588,0.1725,1245.13
359,2019,Igualada,313,8.11,Anoia,Interior,Igualada,33,Barcelona,3413,12838,3385,3192,12555,4584,6605,25393,7969,39967,19636,20331,0.4913,0.5087,0.1653,0.6353,0.1994,4928.11
360,2019,Isona i Conca Dellà,659,139.37,Pallars Jussà,Pre-Pirineu,Tremp,14,Lleida,59,330,159,53,262,156,112,592,315,1019,548,471,0.5378,0.4622,0.1099,0.581,0.3091,7.31
361,2019,Isòvol,1088,10.81,Cerdanya,Pirineu,Puigcerdà,17,Girona,25,104,32,16,76,28,41,180,60,281,161,120,0.573,0.427,0.1459,0.6406,0.2135,25.99
362,2019,Ivars d'Urgell,265,24.32,Pla d'Urgell,Interior,Mollerussa,16,Lleida,95,510,196,103,379,248,198,889,444,1531,801,730,0.5232,0.4768,0.1293,0.5807,0.29,62.95
363,2019,Ivars de Noguera,314,27.14,Noguera,Interior,Balaguer,30,Lleida,16,121,34,20,95,48,36,216,82,334,171,163,0.512,0.488,0.1078,0.6467,0.2455,12.31
364,2019,Ivorra,567,15.36,Segarra,Interior,Cervera,21,Lleida,2,40,15,2,23,22,4,63,37,104,57,47,0.5481,0.4519,0.0385,0.6058,0.3558,6.77
365,2019,Jafre,44,6.64,Baix Empordà,Costal,"Bisbal d'Empordà, la",36,Girona,31,127,48,17,102,55,48,229,103,380,206,174,0.5421,0.4579,0.1263,0.6026,0.2711,57.23
366,2019,"Jonquera, la",110,56.93,Alt Empordà,Costal,Figueres,68,Girona,315,1111,211,270,1112,271,585,2223,482,3290,1637,1653,0.4976,0.5024,0.1778,0.6757,0.1465,57.79
367,2019,Jorba,380,30.9,Anoia,Interior,Igualada,33,Barcelona,73,303,48,66,282,63,139,585,111,835,424,411,0.5078,0.4922,0.1665,0.7006,0.1329,27.02
368,2019,Josa i Tuixén,1206,68.16,Alt Urgell,Pirineu,"Seu d'Urgell, la",19,Lleida,3,37,18,4,28,16,7,65,34,106,58,48,0.5472,0.4528,0.066,0.6132,0.3208,1.56
369,2019,Juià,94,8.36,Gironès,Interior,Girona,27,Girona,30,115,29,23,95,31,53,210,60,323,174,149,0.5387,0.4613,0.1641,0.6502,0.1858,38.64
370,2019,Juncosa,575,76.49,Garrigues,Interior,"Borges Blanques, les",24,Lleida,9,139,56,24,98,60,33,237,116,386,204,182,0.5285,0.4715,0.0855,0.614,0.3005,5.05
371,2019,Juneda,264,47.33,Garrigues,Interior,"Borges Blanques, les",24,Lleida,282,1232,340,237,988,396,519,2220,736,3475,1854,1621,0.5335,0.4665,0.1494,0.6388,0.2118,73.42
372,2019,Les,634,23.45,Val d'Aran,Pirineu,Vielha,9,Lleida,65,347,51,85,325,73,150,672,124,946,463,483,0.4894,0.5106,0.1586,0.7104,0.1311,40.34
373,2019,Linyola,248,28.66,Pla d'Urgell,Interior,Mollerussa,16,Lleida,191,909,265,206,826,303,397,1735,568,2700,1365,1335,0.5056,0.4944,0.147,0.6426,0.2104,94.21
374,2019,"Llacuna, la",615,52.23,Anoia,Interior,Igualada,33,Barcelona,54,321,100,44,227,124,98,548,224,870,475,395,0.546,0.454,0.1126,0.6299,0.2575,16.66
375,2019,Lladó,197,13.5,Alt Empordà,Costal,Figueres,68,Girona,79,255,64,91,264,65,170,519,129,818,398,420,0.4866,0.5134,0.2078,0.6345,0.1577,60.59
376,2019,Lladorre,1052,146.98,Pallars Sobirà,Pirineu,Sort,15,Lleida,14,74,28,14,69,31,28,143,59,230,116,114,0.5043,0.4957,0.1217,0.6217,0.2565,1.56
377,2019,Lladurs,834,128.03,Solsonès,Pre-Pirineu,Solsona,15,Lleida,6,55,30,10,50,25,16,105,55,176,91,85,0.517,0.483,0.0909,0.5966,0.3125,1.37
378,2019,"Llagosta, la",45,3.03,Vallès Oriental,Interior,Granollers,39,Barcelona,1096,4471,1108,1104,4268,1433,2200,8739,2541,13480,6675,6805,0.4952,0.5048,0.1632,0.6483,0.1885,4448.84
379,2019,Llagostera,160,76.38,Gironès,Interior,Girona,27,Girona,754,2921,628,705,2631,814,1459,5552,1442,8453,4303,4150,0.5091,0.4909,0.1726,0.6568,0.1706,110.67
380,2019,Llambilles,143,14.58,Gironès,Interior,Girona,27,Girona,62,241,56,51,222,64,113,463,120,696,359,337,0.5158,0.4842,0.1624,0.6652,0.1724,47.74
381,2019,Llanars,983,24.73,Ripollès,Pirineu,Ripoll,19,Girona,28,165,66,36,143,67,64,308,133,505,259,246,0.5129,0.4871,0.1267,0.6099,0.2634,20.42
382,2019,Llançà,4,27.98,Alt Empordà,Costal,Figueres,68,Girona,331,1575,488,319,1503,620,650,3078,1108,4836,2394,2442,0.495,0.505,0.1344,0.6365,0.2291,172.84
383,2019,Llardecans,397,66.04,Segrià,Costal,Lleida,38,Lleida,22,146,68,16,114,85,38,260,153,451,236,215,0.5233,0.4767,0.0843,0.5765,0.3392,6.83
384,2019,Llavorsí,811,68.51,Pallars Sobirà,Pirineu,Sort,15,Lleida,22,123,35,21,117,34,43,240,69,352,180,172,0.5114,0.4886,0.1222,0.6818,0.196,5.14
385,2019,Lleida,155,212.3,Segrià,Costal,Lleida,38,Lleida,11024,47349,10284,10465,45363,14471,21489,92712,24755,138956,68657,70299,0.4941,0.5059,0.1546,0.6672,0.1781,654.53
386,2019,Llers,142,21.28,Alt Empordà,Costal,Figueres,68,Girona,85,410,122,86,400,136,171,810,258,1239,617,622,0.498,0.502,0.138,0.6538,0.2082,58.22
387,2019,Lles de Cerdanya,1471,102.79,Cerdanya,Pirineu,Puigcerdà,17,Girona,16,93,39,14,63,28,30,156,67,253,148,105,0.585,0.415,0.1186,0.6166,0.2648,2.46
388,2019,Lliçà d'Amunt,145,22.33,Vallès Oriental,Interior,Granollers,39,Barcelona,1282,5307,1230,1149,4991,1297,2431,10298,2527,15256,7819,7437,0.5125,0.4875,0.1593,0.675,0.1656,683.21
389,2019,Lliçà de Vall,125,10.83,Vallès Oriental,Interior,Granollers,39,Barcelona,534,2203,598,471,2112,624,1005,4315,1222,6542,3335,3207,0.5098,0.4902,0.1536,0.6596,0.1868,604.06
390,2019,Llimiana,790,41.68,Pallars Jussà,Pre-Pirineu,Tremp,14,Lleida,8,52,28,3,35,19,11,87,47,145,88,57,0.6069,0.3931,0.0759,0.6,0.3241,3.48
391,2019,Llinars del Vallès,198,27.63,Vallès Oriental,Interior,Granollers,39,Barcelona,816,3343,787,683,3325,984,1499,6668,1771,9938,4946,4992,0.4977,0.5023,0.1508,0.671,0.1782,359.68
392,2019,Llívia,1224,12.93,Cerdanya,Pirineu,Puigcerdà,17,Girona,90,535,123,93,446,130,183,981,253,1417,748,669,0.5279,0.4721,0.1291,0.6923,0.1785,109.59
393,2019,"Lloar, el",219,6.64,Priorat,Interior,Falset,23,Tarragona,6,33,19,9,29,11,15,62,30,107,58,49,0.5421,0.4579,0.1402,0.5794,0.2804,16.11
394,2019,Llobera,855,39.23,Solsonès,Pre-Pirineu,Solsona,15,Lleida,17,61,26,7,47,30,24,108,56,188,104,84,0.5532,0.4468,0.1277,0.5745,0.2979,4.79
395,2019,Llorac,648,23.33,Conca de Barberà,Interior,Montblanc,22,Tarragona,3,34,15,4,33,11,7,67,26,100,52,48,0.52,0.48,0.07,0.67,0.26,4.29
396,2019,Llorenç del Penedès,162,4.61,Baix Penedès,Costal,"Vendrell, el",14,Tarragona,212,762,198,185,761,275,397,1523,473,2393,1172,1221,0.4898,0.5102,0.1659,0.6364,0.1977,519.09
397,2019,Lloret de Mar,5,48.71,Selva,Costal,Sta. Coloma de Farners,26,Girona,3066,13982,2480,2901,12900,3044,5967,26882,5524,38373,19528,18845,0.5089,0.4911,0.1555,0.7005,0.144,787.78
398,2019,"Llosses, les",895,114.02,Ripollès,Pirineu,Ripoll,19,Girona,19,83,19,19,61,17,38,144,36,218,121,97,0.555,0.445,0.1743,0.6606,0.1651,1.91
399,2019,Lluçà,745,52.98,Osona,Interior,Vic,50,Barcelona,21,93,20,30,88,21,51,181,41,273,134,139,0.4908,0.5092,0.1868,0.663,0.1502,5.15
400,2019,Maçanet de Cabrenys,370,67.91,Alt Empordà,Costal,Figueres,68,Girona,32,220,88,38,198,112,70,418,200,688,340,348,0.4942,0.5058,0.1017,0.6076,0.2907,10.13
401,2019,Maçanet de la Selva,100,45.58,Selva,Costal,Sta. Coloma de Farners,26,Girona,518,2462,618,555,2188,665,1073,4650,1283,7006,3598,3408,0.5136,0.4864,0.1532,0.6637,0.1831,153.71
402,2019,Madremanya,177,13.72,Gironès,Interior,Girona,27,Girona,30,82,26,23,91,31,53,173,57,283,138,145,0.4876,0.5124,0.1873,0.6113,0.2014,20.63
403,2019,Maià de Montcal,241,17.29,Garrotxa,Pre-Pirineu,Olot,21,Girona,30,171,50,32,119,47,62,290,97,449,251,198,0.559,0.441,0.1381,0.6459,0.216,25.97
404,2019,Maials,395,57.08,Segrià,Costal,Lleida,38,Lleida,46,336,135,45,225,133,91,561,268,920,517,403,0.562,0.438,0.0989,0.6098,0.2913,16.12
405,2019,Maldà,428,31.36,Urgell,Interior,Tàrrega,20,Lleida,16,65,28,7,68,36,23,133,64,220,109,111,0.4955,0.5045,0.1045,0.6045,0.2909,7.02
406,2019,Malgrat de Mar,4,8.82,Maresme,Costal,Mataró,30,Barcelona,1369,6266,1645,1297,5836,2166,2666,12102,3811,18579,9280,9299,0.4995,0.5005,0.1435,0.6514,0.2051,2106.46
407,2019,Malla,580,11.01,Osona,Interior,Vic,50,Barcelona,26,89,24,17,86,31,43,175,55,273,139,134,0.5092,0.4908,0.1575,0.641,0.2015,24.8
408,2019,Manlleu,461,17.23,Osona,Interior,Vic,50,Barcelona,1790,6987,1537,1731,6450,2078,3521,13437,3615,20573,10314,10259,0.5013,0.4987,0.1711,0.6531,0.1757,1194.02
409,2019,Manresa,238,41.65,Bages,Interior,Manresa,30,Barcelona,6432,25227,6407,5970,24667,9011,12402,49894,15418,77714,38066,39648,0.4898,0.5102,0.1596,0.642,0.1984,1865.88
410,2019,Marçà,315,16.06,Priorat,Interior,Falset,23,Tarragona,40,208,66,36,179,65,76,387,131,594,314,280,0.5286,0.4714,0.1279,0.6515,0.2205,36.99
411,2019,Margalef,379,34.66,Priorat,Interior,Falset,23,Tarragona,4,37,18,2,20,16,6,57,34,97,59,38,0.6082,0.3918,0.0619,0.5876,0.3505,2.8
412,2019,Marganell,291,13.53,Bages,Interior,Manresa,30,Barcelona,17,85,29,6,90,39,23,175,68,266,131,135,0.4925,0.5075,0.0865,0.6579,0.2556,19.66
413,2019,Martorell,56,12.76,Baix Llobregat,Costal,St. Feliu de Llobregat,30,Barcelona,2546,9774,2009,2376,8844,2640,4922,18618,4649,28189,14329,13860,0.5083,0.4917,0.1746,0.6605,0.1649,2209.17
414,2019,Martorelles,96,3.61,Vallès Oriental,Interior,Granollers,39,Barcelona,361,1632,429,321,1530,528,682,3162,957,4801,2422,2379,0.5045,0.4955,0.1421,0.6586,0.1993,1329.92
415,2019,Mas de Barberans,348,78.8,Montsià,Costal,Amposta,12,Tarragona,23,182,83,27,161,102,50,343,185,578,288,290,0.4983,0.5017,0.0865,0.5934,0.3201,7.34
416,2019,Masarac,85,12.55,Alt Empordà,Costal,Figueres,68,Girona,15,107,28,17,90,31,32,197,59,288,150,138,0.5208,0.4792,0.1111,0.684,0.2049,22.95
417,2019,Masdenverge,54,14.61,Montsià,Costal,Amposta,12,Tarragona,70,345,131,65,327,132,135,672,263,1070,546,524,0.5103,0.4897,0.1262,0.628,0.2458,73.24
418,2019,"Masies de Roda, les",468,16.41,Osona,Interior,Vic,50,Barcelona,52,224,79,49,220,76,101,444,155,700,355,345,0.5071,0.4929,0.1443,0.6343,0.2214,42.66
419,2019,"Masies de Voltregà, les",533,22.35,Osona,Interior,Vic,50,Barcelona,232,1059,260,216,1054,320,448,2113,580,3141,1551,1590,0.4938,0.5062,0.1426,0.6727,0.1847,140.54
420,2019,Masllorenç,304,6.55,Baix Penedès,Costal,"Vendrell, el",14,Tarragona,44,192,47,32,138,51,76,330,98,504,283,221,0.5615,0.4385,0.1508,0.6548,0.1944,76.95
421,2019,"Masnou, el",27,3.39,Maresme,Costal,Mataró,30,Barcelona,1787,7688,1882,1659,7822,2677,3446,15510,4559,23515,11357,12158,0.483,0.517,0.1465,0.6596,0.1939,6936.58
422,2019,"Masó, la",115,3.57,Alt Camp,Interior,Valls,23,Tarragona,22,84,40,16,75,39,38,159,79,276,146,130,0.529,0.471,0.1377,0.5761,0.2862,77.31
423,2019,Maspujols,214,3.66,Baix Camp,Costal,Reus,28,Tarragona,86,281,59,67,272,62,153,553,121,827,426,401,0.5151,0.4849,0.185,0.6687,0.1463,225.96
424,2019,Masquefa,257,17.06,Anoia,Interior,Igualada,33,Barcelona,825,3216,600,825,3057,688,1650,6273,1288,9211,4641,4570,0.5039,0.4961,0.1791,0.681,0.1398,539.92
425,2019,"Masroig, el",192,15.51,Priorat,Interior,Falset,23,Tarragona,30,166,74,27,128,72,57,294,146,497,270,227,0.5433,0.4567,0.1147,0.5915,0.2938,32.04
426,2019,Massalcoreig,94,14.14,Segrià,Costal,Lleida,38,Lleida,23,256,59,25,158,77,48,414,136,598,338,260,0.5652,0.4348,0.0803,0.6923,0.2274,42.29
427,2019,Massanes,164,26.07,Selva,Costal,Sta. Coloma de Farners,26,Girona,77,242,86,67,220,69,144,462,155,761,405,356,0.5322,0.4678,0.1892,0.6071,0.2037,29.19
428,2019,Massoteres,502,26.11,Segarra,Interior,Cervera,21,Lleida,19,80,20,21,59,19,40,139,39,218,119,99,0.5459,0.4541,0.1835,0.6376,0.1789,8.35
429,2019,Matadepera,423,25.36,Vallès Occidental,Interior,Sabadell i Terrassa,23,Barcelona,885,3020,752,824,3023,822,1709,6043,1574,9326,4657,4669,0.4994,0.5006,0.1833,0.648,0.1688,367.74
430,2019,Mataró,28,22.53,Maresme,Costal,Mataró,30,Barcelona,10811,43291,9535,10177,41606,12845,20988,84897,22380,128265,63637,64628,0.4961,0.5039,0.1636,0.6619,0.1745,5693.08
431,2019,Mediona,430,47.55,Alt Penedès,Interior,Vilafranca del Penedès,27,Barcelona,207,729,223,194,700,269,401,1429,492,2322,1159,1163,0.4991,0.5009,0.1727,0.6154,0.2119,48.83
432,2019,Menàrguens,205,20.25,Noguera,Interior,Balaguer,30,Lleida,33,307,100,38,218,110,71,525,210,806,440,366,0.5459,0.4541,0.0881,0.6514,0.2605,39.8
433,2019,Meranges,1539,37.34,Cerdanya,Pirineu,Puigcerdà,17,Girona,11,34,13,7,30,9,18,64,22,104,58,46,0.5577,0.4423,0.1731,0.6154,0.2115,2.79
434,2019,Mieres,286,26.29,Garrotxa,Pre-Pirineu,Olot,21,Girona,16,106,38,24,89,45,40,195,83,318,160,158,0.5031,0.4969,0.1258,0.6132,0.261,12.1
435,2019,"Milà, el",166,4.13,Alt Camp,Interior,Valls,23,Tarragona,11,55,19,17,51,25,28,106,44,178,85,93,0.4775,0.5225,0.1573,0.5955,0.2472,43.1
436,2019,Miralcamp,287,14.87,Pla d'Urgell,Interior,Mollerussa,16,Lleida,111,427,139,110,413,151,221,840,290,1351,677,674,0.5011,0.4989,0.1636,0.6218,0.2147,90.85
437,2019,Miravet,43,32.33,Ribera d'Ebre,Interior,Móra d'Ebre,14,Tarragona,47,234,88,36,180,106,83,414,194,691,369,322,0.534,0.466,0.1201,0.5991,0.2808,21.37
438,2019,Moià,717,75.31,Moianès,Interior,Moià,10,Barcelona,490,2225,475,504,1956,617,994,4181,1092,6267,3190,3077,0.509,0.491,0.1586,0.6671,0.1742,83.22
439,2019,"Molar, el",228,22.81,Priorat,Interior,Falset,23,Tarragona,13,102,43,9,80,50,22,182,93,297,158,139,0.532,0.468,0.0741,0.6128,0.3131,13.02
440,2019,Molins de Rei,37,15.94,Baix Llobregat,Costal,St. Feliu de Llobregat,30,Barcelona,2325,8400,1887,2177,8576,2503,4502,16976,4390,25868,12612,13256,0.4876,0.5124,0.174,0.6563,0.1697,1622.84
441,2019,Mollerussa,250,7.08,Pla d'Urgell,Interior,Mollerussa,16,Lleida,1386,5262,895,1304,4638,1198,2690,9900,2093,14683,7543,7140,0.5137,0.4863,0.1832,0.6742,0.1425,2073.87
442,2019,Mollet de Peralada,59,6.04,Alt Empordà,Costal,Figueres,68,Girona,15,54,27,14,48,31,29,102,58,189,96,93,0.5079,0.4921,0.1534,0.5397,0.3069,31.29
443,2019,Mollet del Vallès,65,10.77,Vallès Oriental,Interior,Granollers,39,Barcelona,4132,17269,3821,3956,17232,4908,8088,34501,8729,51318,25222,26096,0.4915,0.5085,0.1576,0.6723,0.1701,4764.9
444,2019,Molló,1182,43.09,Ripollès,Pirineu,Ripoll,19,Girona,18,103,41,26,97,52,44,200,93,337,162,175,0.4807,0.5193,0.1306,0.5935,0.276,7.82
445,2019,"Molsosa, la",667,26.89,Solsonès,Pre-Pirineu,Solsona,15,Lleida,2,35,16,4,33,17,6,68,33,107,53,54,0.4953,0.5047,0.0561,0.6355,0.3084,3.98
446,2019,Monistrol de Calders,447,21.97,Moianès,Interior,Moià,10,Barcelona,42,246,69,27,218,80,69,464,149,682,357,325,0.5235,0.4765,0.1012,0.6804,0.2185,31.04
447,2019,Monistrol de Montserrat,161,11.77,Bages,Interior,Manresa,30,Barcelona,237,1047,267,222,936,325,459,1983,592,3034,1551,1483,0.5112,0.4888,0.1513,0.6536,0.1951,257.77
448,2019,Montagut i Oix,276,93.7,Garrotxa,Pre-Pirineu,Olot,21,Girona,63,329,83,61,294,86,124,623,169,916,475,441,0.5186,0.4814,0.1354,0.6801,0.1845,9.78
449,2019,Montblanc,350,91.07,Conca de Barberà,Interior,Montblanc,22,Tarragona,621,2504,612,533,2321,773,1154,4825,1385,7364,3737,3627,0.5075,0.4925,0.1567,0.6552,0.1881,80.86
450,2019,Montbrió del Camp,132,10.7,Baix Camp,Costal,Reus,28,Tarragona,299,988,198,270,906,229,569,1894,427,2890,1485,1405,0.5138,0.4862,0.1969,0.6554,0.1478,270.09
451,2019,Montcada i Reixac,36,23.47,Vallès Occidental,Interior,Sabadell i Terrassa,23,Barcelona,3112,12478,2311,3002,12171,3165,6114,24649,5476,36239,17901,18338,0.494,0.506,0.1687,0.6802,0.1511,1544.06
452,2019,Montclar,728,21.89,Berguedà,Pre-Pirineu,Berga,31,Barcelona,12,40,19,11,41,13,23,81,32,136,71,65,0.5221,0.4779,0.1691,0.5956,0.2353,6.21
453,2019,Montellà i Martinet,967,54.95,Cerdanya,Pirineu,Puigcerdà,17,Girona,37,210,77,20,170,65,57,380,142,579,324,255,0.5596,0.4404,0.0984,0.6563,0.2453,10.54
454,2019,Montesquiu,577,4.94,Osona,Interior,Vic,50,Barcelona,93,315,93,70,307,120,163,622,213,998,501,497,0.502,0.498,0.1633,0.6232,0.2134,202.02
455,2019,Montferrer i Castellbò,732,176.66,Alt Urgell,Pirineu,"Seu d'Urgell, la",19,Lleida,96,349,121,83,301,91,179,650,212,1041,566,475,0.5437,0.4563,0.172,0.6244,0.2037,5.89
456,2019,Montferri,229,19.15,Alt Camp,Interior,Valls,23,Tarragona,33,131,38,39,113,33,72,244,71,387,202,185,0.522,0.478,0.186,0.6305,0.1835,20.21
457,2019,Montgai,286,28.94,Noguera,Interior,Balaguer,30,Lleida,29,209,91,20,161,115,49,370,206,625,329,296,0.5264,0.4736,0.0784,0.592,0.3296,21.6
458,2019,Montgat,20,2.91,Maresme,Costal,Mataró,30,Barcelona,1100,4006,832,983,4098,1022,2083,8104,1854,12041,5938,6103,0.4931,0.5069,0.173,0.673,0.154,4137.8
459,2019,Montmajor,756,76.49,Berguedà,Pre-Pirineu,Berga,31,Barcelona,35,131,65,39,131,63,74,262,128,464,231,233,0.4978,0.5022,0.1595,0.5647,0.2759,6.07
460,2019,Montmaneu,709,13.62,Anoia,Interior,Igualada,33,Barcelona,9,48,26,2,45,20,11,93,46,150,83,67,0.5533,0.4467,0.0733,0.62,0.3067,11.01
461,2019,"Montmell, el",429,72.8,Baix Penedès,Costal,"Vendrell, el",14,Tarragona,112,550,146,115,456,133,227,1006,279,1512,808,704,0.5344,0.4656,0.1501,0.6653,0.1845,20.77
462,2019,Montmeló,72,4.0,Vallès Oriental,Interior,Granollers,39,Barcelona,648,2896,731,625,2901,954,1273,5797,1685,8755,4275,4480,0.4883,0.5117,0.1454,0.6621,0.1925,2188.75
463,2019,Montoliu de Lleida,166,7.34,Segrià,Costal,Lleida,38,Lleida,29,171,51,23,141,74,52,312,125,489,251,238,0.5133,0.4867,0.1063,0.638,0.2556,66.62
464,2019,Montoliu de Segarra,689,29.47,Segarra,Interior,Cervera,21,Lleida,14,59,27,5,47,27,19,106,54,179,100,79,0.5587,0.4413,0.1061,0.5922,0.3017,6.07
465,2019,Montornès de Segarra,605,12.32,Segarra,Interior,Cervera,21,Lleida,2,25,20,8,26,19,10,51,39,100,47,53,0.47,0.53,0.1,0.51,0.39,8.12
466,2019,Montornès del Vallès,116,10.23,Vallès Oriental,Interior,Granollers,39,Barcelona,1497,5613,1141,1495,5279,1368,2992,10892,2509,16393,8251,8142,0.5033,0.4967,0.1825,0.6644,0.1531,1602.44
467,2019,Mont-ral,888,34.72,Alt Camp,Interior,Valls,23,Tarragona,11,65,18,9,47,12,20,112,30,162,94,68,0.5802,0.4198,0.1235,0.6914,0.1852,4.67
468,2019,Mont-ras,88,12.31,Baix Empordà,Costal,"Bisbal d'Empordà, la",36,Girona,113,562,171,87,561,185,200,1123,356,1679,846,833,0.5039,0.4961,0.1191,0.6689,0.212,136.39
469,2019,Mont-roig del Camp,120,63.32,Baix Camp,Costal,Reus,28,Tarragona,997,4184,1079,913,3835,1128,1910,8019,2207,12136,6260,5876,0.5158,0.4842,0.1574,0.6608,0.1819,191.66
470,2019,Montseny,528,26.77,Vallès Oriental,Interior,Granollers,39,Barcelona,26,118,35,24,95,44,50,213,79,342,179,163,0.5234,0.4766,0.1462,0.6228,0.231,12.78
471,2019,Móra d'Ebre,38,45.12,Ribera d'Ebre,Interior,Móra d'Ebre,14,Tarragona,480,1903,462,408,1816,621,888,3719,1083,5690,2845,2845,0.5,0.5,0.1561,0.6536,0.1903,126.11
472,2019,Móra la Nova,31,15.93,Ribera d'Ebre,Interior,Móra d'Ebre,14,Tarragona,214,1053,274,202,994,350,416,2047,624,3087,1541,1546,0.4992,0.5008,0.1348,0.6631,0.2021,193.79
473,2019,"Morell, el",104,5.94,Tarragonès,Costal,Tarragona,22,Tarragona,343,1331,207,331,1230,262,674,2561,469,3704,1881,1823,0.5078,0.4922,0.182,0.6914,0.1266,623.57
474,2019,"Morera de Montsant, la",743,52.88,Priorat,Interior,Falset,23,Tarragona,6,62,17,12,39,16,18,101,33,152,85,67,0.5592,0.4408,0.1184,0.6645,0.2171,2.87
475,2019,Muntanyola,807,40.3,Osona,Interior,Vic,50,Barcelona,51,227,43,65,205,43,116,432,86,634,321,313,0.5063,0.4937,0.183,0.6814,0.1356,15.73
476,2019,Mura,454,47.79,Bages,Interior,Manresa,30,Barcelona,21,73,28,19,61,22,40,134,50,224,122,102,0.5446,0.4554,0.1786,0.5982,0.2232,4.69
477,2019,Nalec,487,9.25,Urgell,Interior,Tàrrega,20,Lleida,3,22,20,2,25,15,5,47,35,87,45,42,0.5172,0.4828,0.0575,0.5402,0.4023,9.41
478,2019,Naut Aran,1267,255.75,Val d'Aran,Pirineu,Vielha,9,Lleida,133,668,134,119,627,122,252,1295,256,1803,935,868,0.5186,0.4814,0.1398,0.7182,0.142,7.05
479,2019,Navarcles,269,5.52,Bages,Interior,Manresa,30,Barcelona,405,1946,563,422,1915,726,827,3861,1289,5977,2914,3063,0.4875,0.5125,0.1384,0.646,0.2157,1082.79
480,2019,Navàs,370,80.62,Bages,Interior,Manresa,30,Barcelona,459,1988,551,451,1876,695,910,3864,1246,6020,2998,3022,0.498,0.502,0.1512,0.6419,0.207,74.67
481,2019,Navata,145,18.48,Alt Empordà,Costal,Figueres,68,Girona,126,424,121,112,470,128,238,894,249,1381,671,710,0.4859,0.5141,0.1723,0.6474,0.1803,74.73
482,2019,Navès,610,145.27,Solsonès,Pre-Pirineu,Solsona,15,Lleida,22,100,25,17,84,32,39,184,57,280,147,133,0.525,0.475,0.1393,0.6571,0.2036,1.93
483,2019,"Nou de Berguedà, la",876,25.01,Berguedà,Pre-Pirineu,Berga,31,Barcelona,6,49,28,11,45,22,17,94,50,161,83,78,0.5155,0.4845,0.1056,0.5839,0.3106,6.44
484,2019,"Nou de Gaià, la",93,4.32,Tarragonès,Costal,Tarragona,22,Tarragona,73,180,47,62,184,57,135,364,104,603,300,303,0.4975,0.5025,0.2239,0.6036,0.1725,139.58
485,2019,Nulles,231,10.61,Alt Camp,Interior,Valls,23,Tarragona,56,167,44,38,129,58,94,296,102,492,267,225,0.5427,0.4573,0.1911,0.6016,0.2073,46.37
486,2019,Odèn,1130,114.38,Solsonès,Pre-Pirineu,Solsona,15,Lleida,9,93,47,5,64,31,14,157,78,249,149,100,0.5984,0.4016,0.0562,0.6305,0.3133,2.18
487,2019,Òdena,421,52.66,Anoia,Interior,Igualada,33,Barcelona,348,1233,267,320,1135,340,668,2368,607,3643,1848,1795,0.5073,0.4927,0.1834,0.65,0.1666,69.18
488,2019,Ogassa,951,45.22,Ripollès,Pirineu,Ripoll,19,Girona,16,87,27,16,65,23,32,152,50,234,130,104,0.5556,0.4444,0.1368,0.6496,0.2137,5.17
489,2019,Olèrdola,189,30.15,Alt Penedès,Interior,Vilafranca del Penedès,27,Barcelona,316,1280,304,301,1191,300,617,2471,604,3692,1900,1792,0.5146,0.4854,0.1671,0.6693,0.1636,122.45
490,2019,Olesa de Bonesvalls,265,30.79,Alt Penedès,Interior,Vilafranca del Penedès,27,Barcelona,163,653,133,143,569,149,306,1222,282,1810,949,861,0.5243,0.4757,0.1691,0.6751,0.1558,58.79
491,2019,Olesa de Montserrat,124,16.63,Baix Llobregat,Costal,St. Feliu de Llobregat,30,Barcelona,2215,8014,1684,2089,7756,2146,4304,15770,3830,23904,11913,11991,0.4984,0.5016,0.1801,0.6597,0.1602,1437.4
492,2019,Oliana,469,32.37,Alt Urgell,Pirineu,"Seu d'Urgell, la",19,Lleida,92,564,250,107,536,261,199,1100,511,1810,906,904,0.5006,0.4994,0.1099,0.6077,0.2823,55.92
493,2019,Oliola,452,86.28,Noguera,Interior,Balaguer,30,Lleida,4,76,26,10,54,27,14,130,53,197,106,91,0.5381,0.4619,0.0711,0.6599,0.269,2.28
494,2019,Olius,742,54.84,Solsonès,Pre-Pirineu,Solsona,15,Lleida,114,323,90,85,293,81,199,616,171,986,527,459,0.5345,0.4655,0.2018,0.6247,0.1734,17.98
495,2019,Olivella,211,38.75,Garraf,Costal,Vilanova i la Geltrú,6,Barcelona,361,1370,254,385,1196,233,746,2566,487,3799,1985,1814,0.5225,0.4775,0.1964,0.6754,0.1282,98.04
496,2019,Olost,572,29.37,Osona,Interior,Vic,50,Barcelona,67,379,142,73,381,156,140,760,298,1198,588,610,0.4908,0.5092,0.1169,0.6344,0.2487,40.79
497,2019,Olot,443,29.03,Garrotxa,Pre-Pirineu,Olot,21,Girona,2687,12028,2854,2568,11098,3993,5255,23126,6847,35228,17569,17659,0.4987,0.5013,0.1492,0.6565,0.1944,1213.5
498,2019,"Oluges, les",528,18.95,Segarra,Interior,Cervera,21,Lleida,10,50,28,5,43,31,15,93,59,167,88,79,0.5269,0.4731,0.0898,0.5569,0.3533,8.81
499,2019,Olvan,553,35.58,Berguedà,Pre-Pirineu,Berga,31,Barcelona,50,285,81,47,266,125,97,551,206,854,416,438,0.4871,0.5129,0.1136,0.6452,0.2412,24.0
500,2019,"Omellons, els",385,11.06,Garrigues,Interior,"Borges Blanques, les",24,Lleida,5,64,42,9,55,36,14,119,78,211,111,100,0.5261,0.4739,0.0664,0.564,0.3697,19.08
501,2019,"Omells de na Gaia, els",560,13.48,Urgell,Interior,Tàrrega,20,Lleida,4,48,20,4,36,19,8,84,39,131,72,59,0.5496,0.4504,0.0611,0.6412,0.2977,9.72
502,2019,Ordis,98,8.55,Alt Empordà,Costal,Figueres,68,Girona,32,121,46,26,110,36,58,231,82,371,199,172,0.5364,0.4636,0.1563,0.6226,0.221,43.39
503,2019,Organyà,558,12.53,Alt Urgell,Pirineu,"Seu d'Urgell, la",19,Lleida,51,240,97,44,218,134,95,458,231,784,388,396,0.4949,0.5051,0.1212,0.5842,0.2946,62.57
504,2019,Orís,576,27.17,Osona,Interior,Vic,50,Barcelona,19,114,26,26,106,24,45,220,50,315,159,156,0.5048,0.4952,0.1429,0.6984,0.1587,11.59
505,2019,Oristà,468,68.49,Osona,Interior,Vic,50,Barcelona,40,158,76,27,159,81,67,317,157,541,274,267,0.5065,0.4935,0.1238,0.586,0.2902,7.9
506,2019,Orpí,375,15.23,Anoia,Interior,Igualada,33,Barcelona,13,55,12,12,43,12,25,98,24,147,80,67,0.5442,0.4558,0.1701,0.6667,0.1633,9.65
507,2019,Òrrius,259,5.66,Maresme,Costal,Mataró,30,Barcelona,70,257,54,63,239,56,133,496,110,739,381,358,0.5156,0.4844,0.18,0.6712,0.1488,130.57
508,2019,Os de Balaguer,463,135.96,Noguera,Interior,Balaguer,30,Lleida,69,327,111,81,296,110,150,623,221,994,507,487,0.5101,0.4899,0.1509,0.6268,0.2223,7.31
509,2019,Osor,340,52.07,Selva,Costal,Sta. Coloma de Farners,26,Girona,28,155,44,20,131,50,48,286,94,428,227,201,0.5304,0.4696,0.1121,0.6682,0.2196,8.22
510,2019,Ossó de Sió,391,26.29,Urgell,Interior,Tàrrega,20,Lleida,15,59,24,15,62,29,30,121,53,204,98,106,0.4804,0.5196,0.1471,0.5931,0.2598,7.76
511,2019,Pacs del Penedès,201,6.27,Alt Penedès,Interior,Vilafranca del Penedès,27,Barcelona,74,315,80,76,295,82,150,610,162,922,469,453,0.5087,0.4913,0.1627,0.6616,0.1757,147.05
512,2019,Palafolls,16,16.56,Maresme,Costal,Mataró,30,Barcelona,881,3233,576,820,3187,708,1701,6420,1284,9405,4690,4715,0.4987,0.5013,0.1809,0.6826,0.1365,567.93
513,2019,Palafrugell,64,26.88,Baix Empordà,Costal,"Bisbal d'Empordà, la",36,Girona,1998,7568,1811,1867,7394,2336,3865,14962,4147,22974,11377,11597,0.4952,0.5048,0.1682,0.6513,0.1805,854.69
514,2019,Palamós,12,13.98,Baix Empordà,Costal,"Bisbal d'Empordà, la",36,Girona,1280,5943,1543,1172,5921,2051,2452,11864,3594,17910,8766,9144,0.4894,0.5106,0.1369,0.6624,0.2007,1281.12
515,2019,"Palau d'Anglesola, el",250,12.27,Pla d'Urgell,Interior,Mollerussa,16,Lleida,176,717,168,181,678,246,357,1395,414,2166,1061,1105,0.4898,0.5102,0.1648,0.644,0.1911,176.53
516,2019,Palau de Santa Eulàlia,86,8.44,Alt Empordà,Costal,Figueres,68,Girona,7,32,13,5,23,11,12,55,24,91,52,39,0.5714,0.4286,0.1319,0.6044,0.2637,10.78
517,2019,Palau-sator,20,12.39,Baix Empordà,Costal,"Bisbal d'Empordà, la",36,Girona,24,105,37,22,87,35,46,192,72,310,166,144,0.5355,0.4645,0.1484,0.6194,0.2323,25.02
518,2019,Palau-saverdera,78,16.45,Alt Empordà,Costal,Figueres,68,Girona,140,448,153,123,443,169,263,891,322,1476,741,735,0.502,0.498,0.1782,0.6037,0.2182,89.73
519,2019,Palau-solità i Plegamans,130,14.93,Vallès Occidental,Interior,Sabadell i Terrassa,23,Barcelona,1170,4976,1100,1215,4999,1311,2385,9975,2411,14771,7246,7525,0.4906,0.5094,0.1615,0.6753,0.1632,989.35
520,2019,"Pallaresos, els",120,5.13,Tarragonès,Costal,Tarragona,22,Tarragona,503,1664,237,479,1598,296,982,3262,533,4777,2404,2373,0.5032,0.4968,0.2056,0.6829,0.1116,931.19
521,2019,Pallejà,41,8.3,Baix Llobregat,Costal,St. Feliu de Llobregat,30,Barcelona,1074,3875,779,954,3817,1009,2028,7692,1788,11508,5728,5780,0.4977,0.5023,0.1762,0.6684,0.1554,1386.51
522,2019,"Palma d'Ebre, la",335,37.92,Ribera d'Ebre,Interior,Móra d'Ebre,14,Tarragona,10,97,59,14,88,72,24,185,131,340,166,174,0.4882,0.5118,0.0706,0.5441,0.3853,8.97
523,2019,"Palma de Cervelló, la",100,5.46,Baix Llobregat,Costal,St. Feliu de Llobregat,30,Barcelona,220,1022,218,219,1018,257,439,2040,475,2954,1460,1494,0.4942,0.5058,0.1486,0.6906,0.1608,541.03
524,2019,Palol de Revardit,152,17.98,Pla de l'Estany,Interior,Banyoles,11,Girona,36,145,47,40,135,52,76,280,99,455,228,227,0.5011,0.4989,0.167,0.6154,0.2176,25.31
525,2019,Pals,55,25.83,Baix Empordà,Costal,"Bisbal d'Empordà, la",36,Girona,167,779,276,160,737,292,327,1516,568,2411,1222,1189,0.5068,0.4932,0.1356,0.6288,0.2356,93.34
526,2019,"Papiol, el",135,8.95,Baix Llobregat,Costal,St. Feliu de Llobregat,30,Barcelona,359,1401,292,352,1365,376,711,2766,668,4145,2052,2093,0.4951,0.5049,0.1715,0.6673,0.1612,463.13
527,2019,Pardines,1226,31.05,Ripollès,Pirineu,Ripoll,19,Girona,12,57,20,10,41,22,22,98,42,162,89,73,0.5494,0.4506,0.1358,0.6049,0.2593,5.22
528,2019,Parets del Vallès,98,9.12,Vallès Oriental,Interior,Granollers,39,Barcelona,1699,6541,1301,1575,6334,1632,3274,12875,2933,19082,9541,9541,0.5,0.5,0.1716,0.6747,0.1537,2092.32
529,2019,Parlavà,40,6.18,Baix Empordà,Costal,"Bisbal d'Empordà, la",36,Girona,28,126,45,27,115,53,55,241,98,394,199,195,0.5051,0.4949,0.1396,0.6117,0.2487,63.75
530,2019,"Preses, les",474,9.39,Garrotxa,Pre-Pirineu,Olot,21,Girona,154,591,145,151,559,188,305,1150,333,1788,890,898,0.4978,0.5022,0.1706,0.6432,0.1862,190.42
531,2019,Passanant i Belltall,714,27.35,Conca de Barberà,Interior,Montblanc,22,Tarragona,4,63,28,3,36,29,7,99,57,163,95,68,0.5828,0.4172,0.0429,0.6074,0.3497,5.96
532,2019,Pau,33,10.7,Alt Empordà,Costal,Figueres,68,Girona,39,175,71,32,166,77,71,341,148,560,285,275,0.5089,0.4911,0.1268,0.6089,0.2643,52.34
533,2019,Paüls,378,43.83,Baix Ebre,Costal,Tortosa,14,Tarragona,35,146,96,30,154,95,65,300,191,556,277,279,0.4982,0.5018,0.1169,0.5396,0.3435,12.69
534,2019,Pedret i Marzà,22,8.65,Alt Empordà,Costal,Figueres,68,Girona,20,65,16,17,61,19,37,126,35,198,101,97,0.5101,0.4899,0.1869,0.6364,0.1768,22.89
535,2019,Penelles,276,25.51,Noguera,Interior,Balaguer,30,Lleida,29,168,65,25,106,59,54,274,124,452,262,190,0.5796,0.4204,0.1195,0.6062,0.2743,17.72
536,2019,"Pera, la",93,11.54,Baix Empordà,Costal,"Bisbal d'Empordà, la",36,Girona,39,148,34,30,130,65,69,278,99,446,221,225,0.4955,0.5045,0.1547,0.6233,0.222,38.65
537,2019,Perafita,754,19.59,Osona,Interior,Vic,50,Barcelona,25,123,54,22,117,54,47,240,108,395,202,193,0.5114,0.4886,0.119,0.6076,0.2734,20.16
538,2019,Perafort,125,9.54,Tarragonès,Costal,Tarragona,22,Tarragona,142,439,73,115,411,81,257,850,154,1261,654,607,0.5186,0.4814,0.2038,0.6741,0.1221,132.18
539,2019,Peralada,32,43.61,Alt Empordà,Costal,Figueres,68,Girona,124,623,159,137,596,211,261,1219,370,1850,906,944,0.4897,0.5103,0.1411,0.6589,0.2,42.42
540,2019,Peramola,566,56.17,Alt Urgell,Pirineu,"Seu d'Urgell, la",19,Lleida,15,115,47,15,101,54,30,216,101,347,177,170,0.5101,0.4899,0.0865,0.6225,0.2911,6.18
541,2019,"Perelló, el",142,100.67,Baix Ebre,Costal,Tortosa,14,Tarragona,193,858,370,201,771,377,394,1629,747,2770,1421,1349,0.513,0.487,0.1422,0.5881,0.2697,27.52
542,2019,Piera,324,57.2,Anoia,Interior,Igualada,33,Barcelona,1322,5463,1191,1234,4932,1461,2556,10395,2652,15603,7976,7627,0.5112,0.4888,0.1638,0.6662,0.17,272.78
543,2019,"Piles, les",676,22.39,Conca de Barberà,Interior,Montblanc,22,Tarragona,22,69,29,20,58,14,42,127,43,212,120,92,0.566,0.434,0.1981,0.5991,0.2028,9.47
544,2019,Pineda de Mar,10,10.74,Maresme,Costal,Mataró,30,Barcelona,1983,9069,2536,1940,8605,3139,3923,17674,5675,27272,13588,13684,0.4982,0.5018,0.1438,0.6481,0.2081,2539.29
545,2019,"Pinell de Brai, el",189,56.99,Terra Alta,Interior,Gandesa,12,Tarragona,55,331,130,51,270,180,106,601,310,1017,516,501,0.5074,0.4926,0.1042,0.591,0.3048,17.85
546,2019,Pinell de Solsonès,800,91.11,Solsonès,Pre-Pirineu,Solsona,15,Lleida,12,77,29,6,47,29,18,124,58,200,118,82,0.59,0.41,0.09,0.62,0.29,2.2
547,2019,Pinós,823,104.32,Solsonès,Pre-Pirineu,Solsona,15,Lleida,18,99,34,24,79,33,42,178,67,287,151,136,0.5261,0.4739,0.1463,0.6202,0.2334,2.75
548,2019,Pira,385,8.01,Conca de Barberà,Interior,Montblanc,22,Tarragona,39,173,49,34,146,52,73,319,101,493,261,232,0.5294,0.4706,0.1481,0.6471,0.2049,61.55
549,2019,"Pla de Santa Maria, el",381,34.99,Alt Camp,Interior,Valls,23,Tarragona,179,827,209,157,713,242,336,1540,451,2327,1215,1112,0.5221,0.4779,0.1444,0.6618,0.1938,66.5
550,2019,"Pla del Penedès, el",216,9.57,Alt Penedès,Interior,Vilafranca del Penedès,27,Barcelona,107,426,103,118,390,112,225,816,215,1256,636,620,0.5064,0.4936,0.1791,0.6497,0.1712,131.24
551,2019,"Planes d'Hostoles, les",370,37.5,Garrotxa,Pre-Pirineu,Olot,21,Girona,127,515,209,101,475,256,228,990,465,1683,851,832,0.5056,0.4944,0.1355,0.5882,0.2763,44.88
552,2019,Planoles,1136,18.75,Ripollès,Pirineu,Ripoll,19,Girona,18,104,35,15,78,38,33,182,73,288,157,131,0.5451,0.4549,0.1146,0.6319,0.2535,15.36
553,2019,"Plans de Sió, els",412,55.89,Segarra,Interior,Cervera,21,Lleida,23,180,69,28,132,74,51,312,143,506,272,234,0.5375,0.4625,0.1008,0.6166,0.2826,9.05
554,2019,"Poal, el",216,8.88,Pla d'Urgell,Interior,Mollerussa,16,Lleida,47,218,75,32,191,85,79,409,160,648,340,308,0.5247,0.4753,0.1219,0.6312,0.2469,72.97
555,2019,"Pobla de Cérvoles, la",663,61.92,Garrigues,Interior,"Borges Blanques, les",24,Lleida,9,74,24,3,45,36,12,119,60,191,107,84,0.5602,0.4398,0.0628,0.623,0.3141,3.08
556,2019,"Pobla de Claramunt, la",265,18.54,Anoia,Interior,Igualada,33,Barcelona,195,714,195,199,658,232,394,1372,427,2193,1104,1089,0.5034,0.4966,0.1797,0.6256,0.1947,118.28
557,2019,"Pobla de Lillet, la",843,51.45,Berguedà,Pre-Pirineu,Berga,31,Barcelona,43,323,162,39,304,224,82,627,386,1095,528,567,0.4822,0.5178,0.0749,0.5726,0.3525,21.28
558,2019,"Pobla de Mafumet, la",98,6.21,Tarragonès,Costal,Tarragona,22,Tarragona,432,1416,134,386,1358,178,818,2774,312,3904,1982,1922,0.5077,0.4923,0.2095,0.7106,0.0799,628.66
559,2019,"Pobla de Massaluca, la",357,43.4,Terra Alta,Interior,Gandesa,12,Tarragona,19,101,61,10,76,51,29,177,112,318,181,137,0.5692,0.4308,0.0912,0.5566,0.3522,7.33
560,2019,"Pobla de Montornès, la",56,12.29,Tarragonès,Costal,Tarragona,22,Tarragona,250,948,288,211,857,285,461,1805,573,2839,1486,1353,0.5234,0.4766,0.1624,0.6358,0.2018,231.0
561,2019,"Pobla de Segur, la",524,32.83,Pallars Jussà,Pre-Pirineu,Tremp,14,Lleida,208,925,336,195,870,450,403,1795,786,2984,1469,1515,0.4923,0.5077,0.1351,0.6015,0.2634,90.89
562,2019,Poboleda,343,13.95,Priorat,Interior,Falset,23,Tarragona,15,107,44,21,81,45,36,188,89,313,166,147,0.5304,0.4696,0.115,0.6006,0.2843,22.44
563,2019,Polinyà,123,8.79,Vallès Occidental,Interior,Sabadell i Terrassa,23,Barcelona,892,2985,418,877,2829,478,1769,5814,896,8479,4295,4184,0.5065,0.4935,0.2086,0.6857,0.1057,964.62
564,2019,"Pont d'Armentera, el",349,21.67,Alt Camp,Interior,Valls,23,Tarragona,24,163,71,27,140,80,51,303,151,505,258,247,0.5109,0.4891,0.101,0.6,0.299,23.3
565,2019,"Pont de Bar, el",861,42.62,Alt Urgell,Pirineu,"Seu d'Urgell, la",19,Lleida,15,53,19,2,43,25,17,96,44,157,87,70,0.5541,0.4459,0.1083,0.6115,0.2803,3.68
566,2019,Pont de Molins,43,8.66,Alt Empordà,Costal,Figueres,68,Girona,35,174,58,38,173,51,73,347,109,529,267,262,0.5047,0.4953,0.138,0.656,0.206,61.09
567,2019,"Pont de Suert, el",838,148.14,Alta Ribagorça,Pirineu,"Pont de Suert, el",3,Lleida,165,747,195,149,699,265,314,1446,460,2220,1107,1113,0.4986,0.5014,0.1414,0.6514,0.2072,14.99
568,2019,"Pont de Vilomara i Rocafort, el",202,27.41,Bages,Interior,Manresa,30,Barcelona,349,1307,313,293,1199,369,642,2506,682,3830,1969,1861,0.5141,0.4859,0.1676,0.6543,0.1781,139.73
569,2019,Pontils,551,67.56,Conca de Barberà,Interior,Montblanc,22,Tarragona,3,38,25,4,33,14,7,71,39,117,66,51,0.5641,0.4359,0.0598,0.6068,0.3333,1.73
570,2019,Pontons,584,25.94,Alt Penedès,Interior,Vilafranca del Penedès,27,Barcelona,39,194,56,26,166,51,65,360,107,532,289,243,0.5432,0.4568,0.1222,0.6767,0.2011,20.51
571,2019,Pontós,94,13.66,Alt Empordà,Costal,Figueres,68,Girona,26,87,28,17,81,27,43,168,55,266,141,125,0.5301,0.4699,0.1617,0.6316,0.2068,19.47
572,2019,Ponts,363,30.52,Noguera,Interior,Balaguer,30,Lleida,190,861,254,173,796,327,363,1657,581,2601,1305,1296,0.5017,0.4983,0.1396,0.6371,0.2234,85.22
573,2019,Porqueres,148,33.52,Pla de l'Estany,Interior,Banyoles,11,Girona,385,1525,378,395,1487,451,780,3012,829,4621,2288,2333,0.4951,0.5049,0.1688,0.6518,0.1794,137.86
574,2019,Porrera,316,28.83,Priorat,Interior,Falset,23,Tarragona,17,169,43,23,125,62,40,294,105,439,229,210,0.5216,0.4784,0.0911,0.6697,0.2392,15.23
575,2019,"Port de la Selva, el",12,41.62,Alt Empordà,Costal,Figueres,68,Girona,62,308,131,50,281,138,112,589,269,970,501,469,0.5165,0.4835,0.1155,0.6072,0.2773,23.31
576,2019,Portbou,28,9.22,Alt Empordà,Costal,Figueres,68,Girona,36,323,169,48,291,208,84,614,377,1075,528,547,0.4912,0.5088,0.0781,0.5712,0.3507,116.59
577,2019,"Portella, la",259,12.31,Segrià,Costal,Lleida,38,Lleida,46,291,75,35,218,63,81,509,138,728,412,316,0.5659,0.4341,0.1113,0.6992,0.1896,59.14
578,2019,Pradell de la Teixeta,463,21.83,Priorat,Interior,Falset,23,Tarragona,4,45,21,11,51,20,15,96,41,152,70,82,0.4605,0.5395,0.0987,0.6316,0.2697,6.96
579,2019,Prades,950,32.58,Baix Camp,Costal,Reus,28,Tarragona,41,196,72,30,170,80,71,366,152,589,309,280,0.5246,0.4754,0.1205,0.6214,0.2581,18.08
580,2019,Prat de Comte,363,26.43,Terra Alta,Interior,Gandesa,12,Tarragona,12,64,22,7,45,33,19,109,55,183,98,85,0.5355,0.4645,0.1038,0.5956,0.3005,6.92
581,2019,"Prat de Llobregat, el",8,31.41,Baix Llobregat,Costal,St. Feliu de Llobregat,30,Barcelona,5118,21184,5319,4919,21077,6982,10037,42261,12301,64599,31621,32978,0.4895,0.5105,0.1554,0.6542,0.1904,2056.64
582,2019,Pratdip,245,36.27,Baix Camp,Costal,Reus,28,Tarragona,39,231,125,38,184,121,77,415,246,738,395,343,0.5352,0.4648,0.1043,0.5623,0.3333,20.35
583,2019,Prats de Lluçanès,707,13.78,Osona,Interior,Vic,50,Barcelona,158,861,261,159,814,316,317,1675,577,2569,1280,1289,0.4982,0.5018,0.1234,0.652,0.2246,186.43
584,2019,"Prats de Rei, els",608,26.06,Anoia,Interior,Igualada,33,Barcelona,42,192,49,30,145,74,72,337,123,532,283,249,0.532,0.468,0.1353,0.6335,0.2312,20.41
585,2019,Prats i Sansor,1124,6.57,Cerdanya,Pirineu,Puigcerdà,17,Girona,9,83,22,14,66,25,23,149,47,219,114,105,0.5205,0.4795,0.105,0.6804,0.2146,33.33
586,2019,Preixana,328,21.52,Urgell,Interior,Tàrrega,20,Lleida,24,114,61,27,95,64,51,209,125,385,199,186,0.5169,0.4831,0.1325,0.5429,0.3247,17.89
587,2019,Preixens,315,28.67,Noguera,Interior,Balaguer,30,Lleida,26,121,71,27,111,76,53,232,147,432,218,214,0.5046,0.4954,0.1227,0.537,0.3403,15.07
588,2019,Premià de Dalt,142,6.57,Maresme,Costal,Mataró,30,Barcelona,902,3408,897,822,3432,987,1724,6840,1884,10448,5207,5241,0.4984,0.5016,0.165,0.6547,0.1803,1590.26
589,2019,Premià de Mar,8,2.11,Maresme,Costal,Mataró,30,Barcelona,2165,9217,2322,2055,9103,3257,4220,18320,5579,28119,13704,14415,0.4874,0.5126,0.1501,0.6515,0.1984,13326.54
590,2019,Prullans,1096,21.21,Cerdanya,Pirineu,Puigcerdà,17,Girona,17,66,26,18,77,27,35,143,53,231,109,122,0.4719,0.5281,0.1515,0.619,0.2294,10.89
591,2019,Puigcerdà,1202,18.92,Cerdanya,Pirineu,Puigcerdà,17,Girona,706,3266,613,697,3152,824,1403,6418,1437,9258,4585,4673,0.4952,0.5048,0.1515,0.6932,0.1552,489.32
592,2019,Puigdàlber,239,0.4,Alt Penedès,Interior,Vilafranca del Penedès,27,Barcelona,40,175,41,61,161,48,101,336,89,526,256,270,0.4867,0.5133,0.192,0.6388,0.1692,1315.0
593,2019,Puiggròs,334,9.9,Garrigues,Interior,"Borges Blanques, les",24,Lleida,18,93,27,14,80,44,32,173,71,276,138,138,0.5,0.5,0.1159,0.6268,0.2572,27.88
594,2019,Puigpelat,252,9.48,Alt Camp,Interior,Valls,23,Tarragona,111,424,55,102,390,67,213,814,122,1149,590,559,0.5135,0.4865,0.1854,0.7084,0.1062,121.2
595,2019,Puig-reig,455,45.75,Berguedà,Pre-Pirineu,Berga,31,Barcelona,250,1358,478,245,1230,617,495,2588,1095,4178,2086,2092,0.4993,0.5007,0.1185,0.6194,0.2621,91.32
596,2019,Puigverd d'Agramunt,366,17.0,Urgell,Interior,Tàrrega,20,Lleida,17,96,33,12,69,28,29,165,61,255,146,109,0.5725,0.4275,0.1137,0.6471,0.2392,15.0
597,2019,Puigverd de Lleida,219,12.51,Segrià,Costal,Lleida,38,Lleida,101,477,123,98,404,152,199,881,275,1355,701,654,0.5173,0.4827,0.1469,0.6502,0.203,108.31
598,2019,Pujalt,770,31.43,Anoia,Interior,Igualada,33,Barcelona,23,69,27,13,56,22,36,125,49,210,119,91,0.5667,0.4333,0.1714,0.5952,0.2333,6.68
599,2019,"Quar, la",885,38.25,Berguedà,Pre-Pirineu,Berga,31,Barcelona,6,10,13,3,15,6,9,25,19,53,29,24,0.5472,0.4528,0.1698,0.4717,0.3585,1.39
600,2019,Quart,91,38.09,Gironès,Interior,Girona,27,Girona,418,1200,237,406,1191,272,824,2391,509,3724,1855,1869,0.4981,0.5019,0.2213,0.6421,0.1367,97.77
601,2019,Queralbs,1236,93.47,Ripollès,Pirineu,Ripoll,19,Girona,8,71,25,6,56,25,14,127,50,191,104,87,0.5445,0.4555,0.0733,0.6649,0.2618,2.04
602,2019,Querol,565,72.26,Alt Camp,Interior,Valls,23,Tarragona,28,184,73,23,146,53,51,330,126,507,285,222,0.5621,0.4379,0.1006,0.6509,0.2485,7.02
603,2019,Rabós,106,45.1,Alt Empordà,Costal,Figueres,68,Girona,9,54,26,9,51,29,18,105,55,178,89,89,0.5,0.5,0.1011,0.5899,0.309,3.95
604,2019,Rajadell,361,45.53,Bages,Interior,Manresa,30,Barcelona,31,184,60,43,173,57,74,357,117,548,275,273,0.5018,0.4982,0.135,0.6515,0.2135,12.04
605,2019,Rasquera,174,51.31,Ribera d'Ebre,Interior,Móra d'Ebre,14,Tarragona,43,224,117,43,222,132,86,446,249,781,384,397,0.4917,0.5083,0.1101,0.5711,0.3188,15.22
606,2019,Regencós,78,6.27,Baix Empordà,Costal,"Bisbal d'Empordà, la",36,Girona,15,93,33,16,78,34,31,171,67,269,141,128,0.5242,0.4758,0.1152,0.6357,0.2491,42.9
607,2019,Rellinars,322,17.79,Vallès Occidental,Interior,Sabadell i Terrassa,23,Barcelona,52,284,67,73,245,59,125,529,126,780,403,377,0.5167,0.4833,0.1603,0.6782,0.1615,43.84
608,2019,Renau,175,8.22,Tarragonès,Costal,Tarragona,22,Tarragona,22,55,5,13,54,8,35,109,13,157,82,75,0.5223,0.4777,0.2229,0.6943,0.0828,19.1
609,2019,Reus,117,52.82,Baix Camp,Costal,Reus,28,Tarragona,9105,33384,7926,8634,34625,10699,17739,68009,18625,104373,50415,53958,0.483,0.517,0.17,0.6516,0.1784,1976.01
610,2019,Rialp,725,63.3,Pallars Sobirà,Pirineu,Sort,15,Lleida,39,244,47,35,229,67,74,473,114,661,330,331,0.4992,0.5008,0.112,0.7156,0.1725,10.44
611,2019,"Riba, la",263,7.99,Alt Camp,Interior,Valls,23,Tarragona,36,207,78,28,148,88,64,355,166,585,321,264,0.5487,0.4513,0.1094,0.6068,0.2838,73.22
612,2019,Riba-roja d'Ebre,76,99.14,Ribera d'Ebre,Interior,Móra d'Ebre,14,Tarragona,57,384,152,57,294,182,114,678,334,1126,593,533,0.5266,0.4734,0.1012,0.6021,0.2966,11.36
613,2019,Ribera d'Ondara,570,54.47,Segarra,Interior,Cervera,21,Lleida,21,133,59,23,125,65,44,258,124,426,213,213,0.5,0.5,0.1033,0.6056,0.2911,7.82
614,2019,Ribera d'Urgellet,702,106.96,Alt Urgell,Pirineu,"Seu d'Urgell, la",19,Lleida,78,328,82,69,277,101,147,605,183,935,488,447,0.5219,0.4781,0.1572,0.6471,0.1957,8.74
615,2019,Ribes de Freser,912,41.87,Ripollès,Pirineu,Ripoll,19,Girona,99,563,220,72,511,289,171,1074,509,1754,882,872,0.5029,0.4971,0.0975,0.6123,0.2902,41.89
616,2019,Riells i Viabrea,96,26.98,Selva,Costal,Sta. Coloma de Farners,26,Girona,329,1487,297,292,1411,308,621,2898,605,4124,2113,2011,0.5124,0.4876,0.1506,0.7027,0.1467,152.85
617,2019,"Riera de Gaià, la",28,8.76,Tarragonès,Costal,Tarragona,22,Tarragona,179,575,113,184,544,149,363,1119,262,1744,867,877,0.4971,0.5029,0.2081,0.6416,0.1502,199.09
618,2019,Riner,830,47.1,Solsonès,Pre-Pirineu,Solsona,15,Lleida,21,82,29,20,71,40,41,153,69,263,132,131,0.5019,0.4981,0.1559,0.5817,0.2624,5.58
619,2019,Ripoll,691,73.71,Ripollès,Pirineu,Ripoll,19,Girona,770,3429,1074,704,3293,1416,1474,6722,2490,10686,5273,5413,0.4934,0.5066,0.1379,0.629,0.233,144.97
620,2019,Ripollet,79,4.33,Vallès Occidental,Interior,Sabadell i Terrassa,23,Barcelona,3534,13050,2496,3369,12869,3347,6903,25919,5843,38665,19080,19585,0.4935,0.5065,0.1785,0.6703,0.1511,8929.56
621,2019,Riu de Cerdanya,1173,12.34,Cerdanya,Pirineu,Puigcerdà,17,Girona,2,40,13,3,28,7,5,68,20,93,55,38,0.5914,0.4086,0.0538,0.7312,0.2151,7.54
622,2019,Riudarenes,84,47.6,Selva,Costal,Sta. Coloma de Farners,26,Girona,184,747,194,175,674,208,359,1421,402,2182,1125,1057,0.5156,0.4844,0.1645,0.6512,0.1842,45.84
623,2019,Riudaura,572,23.6,Garrotxa,Pre-Pirineu,Olot,21,Girona,37,153,42,50,151,45,87,304,87,478,232,246,0.4854,0.5146,0.182,0.636,0.182,20.25
624,2019,Riudecanyes,195,17.1,Baix Camp,Costal,Reus,28,Tarragona,100,391,99,79,343,112,179,734,211,1124,590,534,0.5249,0.4751,0.1593,0.653,0.1877,65.73
625,2019,Riudecols,299,19.46,Baix Camp,Costal,Reus,28,Tarragona,73,432,106,79,365,125,152,797,231,1180,611,569,0.5178,0.4822,0.1288,0.6754,0.1958,60.64
626,2019,Riudellots de la Selva,98,13.12,Selva,Costal,Sta. Coloma de Farners,26,Girona,179,719,155,162,681,180,341,1400,335,2076,1053,1023,0.5072,0.4928,0.1643,0.6744,0.1614,158.23
627,2019,Riudoms,125,32.43,Baix Camp,Costal,Reus,28,Tarragona,606,2191,583,522,2006,686,1128,4197,1269,6594,3380,3214,0.5126,0.4874,0.1711,0.6365,0.1924,203.33
628,2019,Riumors,7,6.54,Alt Empordà,Costal,Figueres,68,Girona,19,81,26,17,81,34,36,162,60,258,126,132,0.4884,0.5116,0.1395,0.6279,0.2326,39.45
629,2019,"Roca del Vallès, la",123,36.9,Vallès Oriental,Interior,Granollers,39,Barcelona,941,3652,726,925,3510,896,1866,7162,1622,10650,5319,5331,0.4994,0.5006,0.1752,0.6725,0.1523,288.62
630,2019,Rocafort de Queralt,566,8.47,Conca de Barberà,Interior,Montblanc,22,Tarragona,13,72,37,14,50,39,27,122,76,225,122,103,0.5422,0.4578,0.12,0.5422,0.3378,26.56
631,2019,Roda de Berà,57,16.5,Tarragonès,Costal,Tarragona,22,Tarragona,504,2167,670,495,1991,740,999,4158,1410,6567,3341,3226,0.5088,0.4912,0.1521,0.6332,0.2147,398.0
632,2019,Roda de Ter,443,2.23,Osona,Interior,Vic,50,Barcelona,525,2117,476,508,2030,645,1033,4147,1121,6301,3118,3183,0.4948,0.5052,0.1639,0.6581,0.1779,2825.56
633,2019,Rodonyà,312,8.49,Alt Camp,Interior,Valls,23,Tarragona,37,185,40,24,147,57,61,332,97,490,262,228,0.5347,0.4653,0.1245,0.6776,0.198,57.71
634,2019,Roquetes,14,136.92,Baix Ebre,Costal,Tortosa,14,Tarragona,660,2811,655,599,2483,765,1259,5294,1420,7973,4126,3847,0.5175,0.4825,0.1579,0.664,0.1781,58.23
635,2019,Roses,5,45.91,Alt Empordà,Costal,Figueres,68,Girona,1610,6619,1633,1540,6235,1913,3150,12854,3546,19550,9862,9688,0.5045,0.4955,0.1611,0.6575,0.1814,425.83
636,2019,Rosselló,252,9.92,Segrià,Costal,Lleida,38,Lleida,257,1141,204,274,990,279,531,2131,483,3145,1602,1543,0.5094,0.4906,0.1688,0.6776,0.1536,317.04
637,2019,"Rourell, el",114,2.32,Alt Camp,Interior,Valls,23,Tarragona,29,133,29,23,117,35,52,250,64,366,191,175,0.5219,0.4781,0.1421,0.6831,0.1749,157.76
638,2019,Rubí,123,32.3,Vallès Occidental,Interior,Sabadell i Terrassa,23,Barcelona,6727,26357,5274,6380,25991,6735,13107,52348,12009,77464,38358,39106,0.4952,0.5048,0.1692,0.6758,0.155,2398.27
639,2019,Rubió,629,48.0,Anoia,Interior,Igualada,33,Barcelona,18,82,33,12,69,25,30,151,58,239,133,106,0.5565,0.4435,0.1255,0.6318,0.2427,4.98
640,2019,Rupià,66,5.29,Baix Empordà,Costal,"Bisbal d'Empordà, la",36,Girona,18,82,38,27,75,32,45,157,70,272,138,134,0.5074,0.4926,0.1654,0.5772,0.2574,51.42
641,2019,Rupit i Pruit,822,47.81,Osona,Interior,Vic,50,Barcelona,15,84,40,14,78,48,29,162,88,279,139,140,0.4982,0.5018,0.1039,0.5806,0.3154,5.84
642,2019,Sabadell,190,37.79,Vallès Occidental,Interior,Sabadell i Terrassa,23,Barcelona,17618,69554,16675,16609,69950,23238,34227,139504,39913,213644,103847,109797,0.4861,0.5139,0.1602,0.653,0.1868,5653.45
643,2019,Sagàs,738,44.6,Berguedà,Pre-Pirineu,Berga,31,Barcelona,19,48,13,9,46,13,28,94,26,148,80,68,0.5405,0.4595,0.1892,0.6351,0.1757,3.32
644,2019,Salàs de Pallars,573,20.27,Pallars Jussà,Pre-Pirineu,Tremp,14,Lleida,19,103,52,16,88,42,35,191,94,320,174,146,0.5438,0.4562,0.1094,0.5969,0.2938,15.79
645,2019,Saldes,1215,66.4,Berguedà,Pre-Pirineu,Berga,31,Barcelona,5,104,50,6,71,38,11,175,88,274,159,115,0.5803,0.4197,0.0401,0.6387,0.3212,4.13
646,2019,Sales de Llierca,260,35.82,Garrotxa,Pre-Pirineu,Olot,21,Girona,9,57,11,17,52,8,26,109,19,154,77,77,0.5,0.5,0.1688,0.7078,0.1234,4.3
647,2019,Sallent,278,65.22,Bages,Interior,Manresa,30,Barcelona,452,2022,737,455,2031,961,907,4053,1698,6658,3211,3447,0.4823,0.5177,0.1362,0.6087,0.255,102.09
648,2019,Salomó,165,12.21,Tarragonès,Costal,Tarragona,22,Tarragona,44,196,55,51,151,60,95,347,115,557,295,262,0.5296,0.4704,0.1706,0.623,0.2065,45.62
649,2019,Salou,2,15.13,Tarragonès,Costal,Tarragona,22,Tarragona,2280,10214,1647,2020,9416,1899,4300,19630,3546,27476,14141,13335,0.5147,0.4853,0.1565,0.7144,0.1291,1815.99
650,2019,Salt,83,6.64,Gironès,Interior,Girona,27,Girona,3400,11391,1663,3077,9611,2220,6477,21002,3883,31362,16454,14908,0.5246,0.4754,0.2065,0.6697,0.1238,4723.19
651,2019,Sanaüja,409,32.99,Segarra,Interior,Cervera,21,Lleida,18,125,59,17,96,65,35,221,124,380,202,178,0.5316,0.4684,0.0921,0.5816,0.3263,11.52
652,2019,Sant Adrià de Besòs,14,3.82,Barcelonès,Costal,Barcelona,5,Barcelona,3173,12451,2627,2906,12162,3778,6079,24613,6405,37097,18251,18846,0.492,0.508,0.1639,0.6635,0.1727,9711.26
653,2019,Sant Agustí de Lluçanès,816,13.22,Osona,Interior,Vic,50,Barcelona,2,29,11,7,25,11,9,54,22,85,42,43,0.4941,0.5059,0.1059,0.6353,0.2588,6.43
654,2019,Sant Andreu de la Barca,42,5.5,Baix Llobregat,Costal,St. Feliu de Llobregat,30,Barcelona,2604,9342,1733,2497,9020,2362,5101,18362,4095,27558,13679,13879,0.4964,0.5036,0.1851,0.6663,0.1486,5010.55
655,2019,Sant Andreu de Llavaneres,114,11.83,Maresme,Costal,Mataró,30,Barcelona,906,3662,856,823,3690,1031,1729,7352,1887,10968,5424,5544,0.4945,0.5055,0.1576,0.6703,0.172,927.13
656,2019,Sant Andreu Salou,132,5.96,Gironès,Interior,Girona,27,Girona,14,50,15,10,46,20,24,96,35,155,79,76,0.5097,0.4903,0.1548,0.6194,0.2258,26.01
657,2019,Sant Aniol de Finestres,289,47.73,Garrotxa,Pre-Pirineu,Olot,21,Girona,26,112,39,25,103,36,51,215,75,341,177,164,0.5191,0.4809,0.1496,0.6305,0.2199,7.14
658,2019,Sant Antoni de Vilamajor,258,13.7,Vallès Oriental,Interior,Granollers,39,Barcelona,531,2068,432,501,2088,515,1032,4156,947,6135,3031,3104,0.4941,0.5059,0.1682,0.6774,0.1544,447.81
659,2019,Sant Bartomeu del Grau,868,34.4,Osona,Interior,Vic,50,Barcelona,75,300,85,54,252,92,129,552,177,858,460,398,0.5361,0.4639,0.1503,0.6434,0.2063,24.94
660,2019,Sant Boi de Llobregat,30,21.47,Baix Llobregat,Costal,St. Feliu de Llobregat,30,Barcelona,6652,27453,6772,6241,27286,9201,12893,54739,15973,83605,40877,42728,0.4889,0.5111,0.1542,0.6547,0.1911,3894.04
661,2019,Sant Boi de Lluçanès,813,19.53,Osona,Interior,Vic,50,Barcelona,19,166,84,34,136,102,53,302,186,541,269,272,0.4972,0.5028,0.098,0.5582,0.3438,27.7
662,2019,Sant Carles de la Ràpita,11,53.72,Montsià,Costal,Amposta,12,Tarragona,1006,4752,1480,981,4763,1807,1987,9515,3287,14789,7238,7551,0.4894,0.5106,0.1344,0.6434,0.2223,275.3
663,2019,Sant Cebrià de Vallalta,71,15.68,Maresme,Costal,Mataró,30,Barcelona,305,1200,259,309,1062,250,614,2262,509,3385,1764,1621,0.5211,0.4789,0.1814,0.6682,0.1504,215.88
664,2019,Sant Celoni,152,65.23,Vallès Oriental,Interior,Granollers,39,Barcelona,1566,6028,1345,1465,5734,1766,3031,11762,3111,17904,8939,8965,0.4993,0.5007,0.1693,0.6569,0.1738,274.47
665,2019,Sant Climent de Llobregat,87,10.81,Baix Llobregat,Costal,St. Feliu de Llobregat,30,Barcelona,421,1385,269,386,1389,279,807,2774,548,4129,2075,2054,0.5025,0.4975,0.1954,0.6718,0.1327,381.96
666,2019,Sant Climent Sescebes,86,24.37,Alt Empordà,Costal,Figueres,68,Girona,39,272,53,45,150,67,84,422,120,626,364,262,0.5815,0.4185,0.1342,0.6741,0.1917,25.69
667,2019,Sant Cugat del Vallès,124,48.23,Vallès Occidental,Interior,Sabadell i Terrassa,23,Barcelona,9060,29560,5577,8443,31221,7145,17503,60781,12722,91006,44197,46809,0.4856,0.5144,0.1923,0.6679,0.1398,1886.92
668,2019,Sant Cugat Sesgarrigues,266,6.24,Alt Penedès,Interior,Vilafranca del Penedès,27,Barcelona,81,325,82,100,313,106,181,638,188,1007,488,519,0.4846,0.5154,0.1797,0.6336,0.1867,161.38
669,2019,Sant Esteve de la Sarga,875,92.87,Pallars Jussà,Pre-Pirineu,Tremp,14,Lleida,3,42,27,4,31,17,7,73,44,124,72,52,0.5806,0.4194,0.0565,0.5887,0.3548,1.34
670,2019,Sant Esteve de Palautordera,231,10.64,Vallès Oriental,Interior,Granollers,39,Barcelona,271,937,183,257,975,197,528,1912,380,2820,1391,1429,0.4933,0.5067,0.1872,0.678,0.1348,265.04
671,2019,Sant Esteve Sesrovires,183,18.56,Baix Llobregat,Costal,St. Feliu de Llobregat,30,Barcelona,642,2642,551,597,2520,660,1239,5162,1211,7612,3835,3777,0.5038,0.4962,0.1628,0.6781,0.1591,410.13
672,2019,Sant Feliu de Buixalleu,402,61.94,Selva,Costal,Sta. Coloma de Farners,26,Girona,45,277,88,60,235,78,105,512,166,783,410,373,0.5236,0.4764,0.1341,0.6539,0.212,12.64
673,2019,Sant Feliu de Codines,480,15.0,Vallès Oriental,Interior,Granollers,39,Barcelona,525,2224,419,466,2040,585,991,4264,1004,6259,3168,3091,0.5062,0.4938,0.1583,0.6813,0.1604,417.27
674,2019,Sant Feliu de Guíxols,4,16.23,Baix Empordà,Costal,"Bisbal d'Empordà, la",36,Girona,1732,7130,1940,1657,6999,2467,3389,14129,4407,21925,10802,11123,0.4927,0.5073,0.1546,0.6444,0.201,1350.89
675,2019,Sant Feliu de Llobregat,25,11.82,Baix Llobregat,Costal,St. Feliu de Llobregat,30,Barcelona,3608,14465,3694,3454,14816,4823,7062,29281,8517,44860,21767,23093,0.4852,0.5148,0.1574,0.6527,0.1899,3795.26
676,2019,Sant Feliu de Pallerols,473,34.86,Garrotxa,Pre-Pirineu,Olot,21,Girona,115,421,131,98,435,171,213,856,302,1371,667,704,0.4865,0.5135,0.1554,0.6244,0.2203,39.33
677,2019,Sant Feliu Sasserra,617,22.36,Bages,Interior,Manresa,30,Barcelona,43,195,74,40,168,82,83,363,156,602,312,290,0.5183,0.4817,0.1379,0.603,0.2591,26.92
678,2019,Sant Ferriol,146,42.24,Garrotxa,Pre-Pirineu,Olot,21,Girona,24,76,24,26,71,22,50,147,46,243,124,119,0.5103,0.4897,0.2058,0.6049,0.1893,5.75
679,2019,Sant Fost de Campsentelles,112,13.15,Vallès Oriental,Interior,Granollers,39,Barcelona,671,2867,814,600,2802,983,1271,5669,1797,8737,4352,4385,0.4981,0.5019,0.1455,0.6488,0.2057,664.41
680,2019,Sant Fruitós de Bages,247,22.2,Bages,Interior,Manresa,30,Barcelona,749,2922,624,747,2898,763,1496,5820,1387,8703,4295,4408,0.4935,0.5065,0.1719,0.6687,0.1594,392.03
681,2019,Sant Gregori,112,49.17,Gironès,Interior,Girona,27,Girona,407,1253,299,331,1216,311,738,2469,610,3817,1959,1858,0.5132,0.4868,0.1933,0.6468,0.1598,77.63
682,2019,Sant Guim de Freixenet,738,25.1,Segarra,Interior,Cervera,21,Lleida,74,351,113,79,274,134,153,625,247,1025,538,487,0.5249,0.4751,0.1493,0.6098,0.241,40.84
683,2019,Sant Guim de la Plana,556,12.45,Segarra,Interior,Cervera,21,Lleida,12,66,28,6,46,27,18,112,55,185,106,79,0.573,0.427,0.0973,0.6054,0.2973,14.86
684,2019,Sant Hilari Sacalm,803,83.28,Selva,Costal,Sta. Coloma de Farners,26,Girona,411,1881,551,437,1699,648,848,3580,1199,5627,2843,2784,0.5052,0.4948,0.1507,0.6362,0.2131,67.57
685,2019,Sant Hipòlit de Voltregà,536,0.92,Osona,Interior,Vic,50,Barcelona,286,1177,266,248,1108,399,534,2285,665,3484,1729,1755,0.4963,0.5037,0.1533,0.6559,0.1909,3786.96
686,2019,Sant Iscle de Vallalta,129,17.77,Maresme,Costal,Mataró,30,Barcelona,128,467,92,118,421,106,246,888,198,1332,687,645,0.5158,0.4842,0.1847,0.6667,0.1486,74.96
687,2019,Sant Jaume d'Enveja,7,60.79,Montsià,Costal,Amposta,12,Tarragona,223,1149,393,248,1042,448,471,2191,841,3503,1765,1738,0.5039,0.4961,0.1345,0.6255,0.2401,57.62
688,2019,Sant Jaume de Frontanyà,1072,21.26,Berguedà,Pre-Pirineu,Berga,31,Barcelona,1,9,8,2,7,3,3,16,11,30,18,12,0.6,0.4,0.1,0.5333,0.3667,1.41
689,2019,Sant Jaume de Llierca,203,6.75,Garrotxa,Pre-Pirineu,Olot,21,Girona,69,257,90,60,274,115,129,531,205,865,416,449,0.4809,0.5191,0.1491,0.6139,0.237,128.15
690,2019,Sant Jaume dels Domenys,213,24.45,Baix Penedès,Costal,"Vendrell, el",14,Tarragona,265,874,203,238,811,231,503,1685,434,2622,1342,1280,0.5118,0.4882,0.1918,0.6426,0.1655,107.24
691,2019,Sant Joan de les Abadesses,773,53.67,Ripollès,Pirineu,Ripoll,19,Girona,203,998,403,190,913,525,393,1911,928,3232,1604,1628,0.4963,0.5037,0.1216,0.5913,0.2871,60.22
692,2019,Sant Joan de Mollet,54,3.15,Gironès,Interior,Girona,27,Girona,35,166,47,48,156,55,83,322,102,507,248,259,0.4892,0.5108,0.1637,0.6351,0.2012,160.95
693,2019,Sant Joan de Vilatorrada,277,16.42,Bages,Interior,Manresa,30,Barcelona,926,3628,936,854,3423,1169,1780,7051,2105,10936,5490,5446,0.502,0.498,0.1628,0.6448,0.1925,666.02
694,2019,Sant Joan Despí,10,6.17,Baix Llobregat,Costal,St. Feliu de Llobregat,30,Barcelona,2891,11134,2560,2725,11492,3321,5616,22626,5881,34123,16585,17538,0.486,0.514,0.1646,0.6631,0.1723,5530.47
695,2019,Sant Joan les Fonts,342,31.94,Garrotxa,Pre-Pirineu,Olot,21,Girona,235,981,325,189,890,386,424,1871,711,3006,1541,1465,0.5126,0.4874,0.1411,0.6224,0.2365,94.11
696,2019,Sant Jordi Desvalls,57,11.72,Gironès,Interior,Girona,27,Girona,64,240,76,62,234,85,126,474,161,761,380,381,0.4993,0.5007,0.1656,0.6229,0.2116,64.93
697,2019,Sant Julià de Cerdanyola,954,11.79,Berguedà,Pre-Pirineu,Berga,31,Barcelona,15,84,26,10,65,28,25,149,54,228,125,103,0.5482,0.4518,0.1096,0.6535,0.2368,19.34
698,2019,Sant Julià de Ramis,128,18.8,Gironès,Interior,Girona,27,Girona,345,1202,233,323,1179,233,668,2381,466,3515,1780,1735,0.5064,0.4936,0.19,0.6774,0.1326,186.97
699,2019,Sant Julià de Vilatorta,600,15.94,Osona,Interior,Vic,50,Barcelona,257,1042,240,254,1025,296,511,2067,536,3114,1539,1575,0.4942,0.5058,0.1641,0.6638,0.1721,195.36
700,2019,Sant Julià del Llor i Bonmatí,160,9.73,Selva,Costal,Sta. Coloma de Farners,26,Girona,117,439,95,113,422,100,230,861,195,1286,651,635,0.5062,0.4938,0.1788,0.6695,0.1516,132.17
701,2019,Sant Just Desvern,122,7.81,Baix Llobregat,Costal,St. Feliu de Llobregat,30,Barcelona,1582,5505,1457,1499,5801,1961,3081,11306,3418,17805,8544,9261,0.4799,0.5201,0.173,0.635,0.192,2279.77
702,2019,Sant Llorenç d'Hortons,196,19.72,Alt Penedès,Interior,Vilafranca del Penedès,27,Barcelona,201,837,188,194,795,198,395,1632,386,2413,1226,1187,0.5081,0.4919,0.1637,0.6763,0.16,122.36
703,2019,Sant Llorenç de la Muga,173,31.84,Alt Empordà,Costal,Figueres,68,Girona,18,92,25,16,79,34,34,171,59,264,135,129,0.5114,0.4886,0.1288,0.6477,0.2235,8.29
704,2019,Sant Llorenç de Morunys,925,4.34,Solsonès,Pre-Pirineu,Solsona,15,Lleida,56,279,122,59,283,150,115,562,272,949,457,492,0.4816,0.5184,0.1212,0.5922,0.2866,218.66
705,2019,Sant Llorenç Savall,466,41.11,Vallès Occidental,Interior,Sabadell i Terrassa,23,Barcelona,165,788,244,170,719,287,335,1507,531,2373,1197,1176,0.5044,0.4956,0.1412,0.6351,0.2238,57.72
706,2019,Sant Martí d'Albars,629,14.73,Osona,Interior,Vic,50,Barcelona,7,33,16,10,30,16,17,63,32,112,56,56,0.5,0.5,0.1518,0.5625,0.2857,7.6
707,2019,Sant Martí de Centelles,404,25.55,Osona,Interior,Vic,50,Barcelona,80,446,74,85,375,107,165,821,181,1167,600,567,0.5141,0.4859,0.1414,0.7035,0.1551,45.68
708,2019,Sant Martí de Llémena,256,43.13,Gironès,Interior,Girona,27,Girona,51,231,48,52,214,37,103,445,85,633,330,303,0.5213,0.4787,0.1627,0.703,0.1343,14.68
709,2019,Sant Martí de Riucorb,409,34.9,Urgell,Interior,Tàrrega,20,Lleida,32,198,104,40,156,116,72,354,220,646,334,312,0.517,0.483,0.1115,0.548,0.3406,18.51
710,2019,Sant Martí de Tous,465,39.21,Anoia,Interior,Igualada,33,Barcelona,124,406,107,119,356,123,243,762,230,1235,637,598,0.5158,0.4842,0.1968,0.617,0.1862,31.5
711,2019,Sant Martí Sarroca,291,35.27,Alt Penedès,Interior,Vilafranca del Penedès,27,Barcelona,258,1072,278,283,1048,325,541,2120,603,3264,1608,1656,0.4926,0.5074,0.1657,0.6495,0.1847,92.54
712,2019,Sant Martí Sesgueioles,646,3.87,Anoia,Interior,Igualada,33,Barcelona,22,125,29,16,111,40,38,236,69,343,176,167,0.5131,0.4869,0.1108,0.688,0.2012,88.63
713,2019,Sant Martí Vell,65,17.52,Gironès,Interior,Girona,27,Girona,15,93,23,16,76,29,31,169,52,252,131,121,0.5198,0.4802,0.123,0.6706,0.2063,14.38
714,2019,Sant Mateu de Bages,569,102.92,Bages,Interior,Manresa,30,Barcelona,33,187,82,26,162,113,59,349,195,603,302,301,0.5008,0.4992,0.0978,0.5788,0.3234,5.86
715,2019,Sant Miquel de Campmajor,217,33.22,Pla de l'Estany,Interior,Banyoles,11,Girona,24,81,22,20,63,21,44,144,43,231,127,104,0.5498,0.4502,0.1905,0.6234,0.1861,6.95
716,2019,Sant Miquel de Fluvià,28,3.51,Alt Empordà,Costal,Figueres,68,Girona,59,262,76,53,242,72,112,504,148,764,397,367,0.5196,0.4804,0.1466,0.6597,0.1937,217.66
717,2019,Sant Mori,51,7.53,Alt Empordà,Costal,Figueres,68,Girona,11,61,18,12,55,20,23,116,38,177,90,87,0.5085,0.4915,0.1299,0.6554,0.2147,23.51
718,2019,Sant Pau de Segúries,867,8.74,Ripollès,Pirineu,Ripoll,19,Girona,49,208,90,41,213,96,90,421,186,697,347,350,0.4978,0.5022,0.1291,0.604,0.2669,79.75
719,2019,Sant Pere de Ribes,44,40.8,Garraf,Costal,Vilanova i la Geltrú,6,Barcelona,2591,10594,2083,2547,10373,2531,5138,20967,4614,30719,15268,15451,0.497,0.503,0.1673,0.6825,0.1502,752.92
720,2019,Sant Pere de Riudebitlles,246,5.38,Alt Penedès,Interior,Vilafranca del Penedès,27,Barcelona,225,728,228,193,706,288,418,1434,516,2368,1181,1187,0.4987,0.5013,0.1765,0.6056,0.2179,440.15
721,2019,Sant Pere de Torelló,621,55.13,Osona,Interior,Vic,50,Barcelona,206,809,227,154,732,291,360,1541,518,2419,1242,1177,0.5134,0.4866,0.1488,0.637,0.2141,43.88
722,2019,Sant Pere de Vilamajor,305,34.72,Vallès Oriental,Interior,Granollers,39,Barcelona,370,1565,304,390,1479,364,760,3044,668,4472,2239,2233,0.5007,0.4993,0.1699,0.6807,0.1494,128.8
723,2019,Sant Pere Pescador,5,18.45,Alt Empordà,Costal,Figueres,68,Girona,164,772,148,178,590,190,342,1362,338,2042,1084,958,0.5309,0.4691,0.1675,0.667,0.1655,110.68
724,2019,Sant Pere Sallavinera,588,22.02,Anoia,Interior,Igualada,33,Barcelona,16,47,19,9,36,25,25,83,44,152,82,70,0.5395,0.4605,0.1645,0.5461,0.2895,6.9
725,2019,Sant Pol de Mar,15,7.53,Maresme,Costal,Mataró,30,Barcelona,421,1668,515,399,1686,610,820,3354,1125,5299,2604,2695,0.4914,0.5086,0.1547,0.6329,0.2123,703.72
726,2019,Sant Quintí de Mediona,326,13.84,Alt Penedès,Interior,Vilafranca del Penedès,27,Barcelona,197,770,187,177,696,227,374,1466,414,2254,1154,1100,0.512,0.488,0.1659,0.6504,0.1837,162.86
727,2019,Sant Quirze de Besora,587,8.1,Osona,Interior,Vic,50,Barcelona,140,664,250,152,654,307,292,1318,557,2167,1054,1113,0.4864,0.5136,0.1347,0.6082,0.257,267.53
728,2019,Sant Quirze del Vallès,188,14.07,Vallès Occidental,Interior,Sabadell i Terrassa,23,Barcelona,1903,6663,1299,1858,6894,1524,3761,13557,2823,20141,9865,10276,0.4898,0.5102,0.1867,0.6731,0.1402,1431.49
729,2019,Sant Quirze Safaja,627,26.21,Moianès,Interior,Moià,10,Barcelona,53,242,41,61,193,37,114,435,78,627,336,291,0.5359,0.4641,0.1818,0.6938,0.1244,23.92
730,2019,Sant Ramon,641,18.53,Segarra,Interior,Cervera,21,Lleida,20,154,80,34,124,79,54,278,159,491,254,237,0.5173,0.4827,0.11,0.5662,0.3238,26.5
731,2019,Sant Sadurní d'Anoia,162,18.96,Alt Penedès,Interior,Vilafranca del Penedès,27,Barcelona,1163,4220,965,1062,4276,1201,2225,8496,2166,12887,6348,6539,0.4926,0.5074,0.1727,0.6593,0.1681,679.69
732,2019,Sant Sadurní d'Osormort,531,30.6,Osona,Interior,Vic,50,Barcelona,3,35,9,2,21,8,5,56,17,78,47,31,0.6026,0.3974,0.0641,0.7179,0.2179,2.55
733,2019,Sant Salvador de Guardiola,334,37.15,Bages,Interior,Manresa,30,Barcelona,267,1098,265,251,989,309,518,2087,574,3179,1630,1549,0.5127,0.4873,0.1629,0.6565,0.1806,85.57
734,2019,Sant Vicenç de Castellet,176,17.13,Bages,Interior,Manresa,30,Barcelona,825,3177,758,704,3006,1053,1529,6183,1811,9523,4760,4763,0.4998,0.5002,0.1606,0.6493,0.1902,555.93
735,2019,Sant Vicenç de Montalt,143,8.05,Maresme,Costal,Mataró,30,Barcelona,561,2091,547,504,2128,576,1065,4219,1123,6407,3199,3208,0.4993,0.5007,0.1662,0.6585,0.1753,795.9
736,2019,Sant Vicenç de Torelló,555,6.56,Osona,Interior,Vic,50,Barcelona,176,685,158,151,679,209,327,1364,367,2058,1019,1039,0.4951,0.5049,0.1589,0.6628,0.1783,313.72
737,2019,Sant Vicenç dels Horts,22,9.12,Baix Llobregat,Costal,St. Feliu de Llobregat,30,Barcelona,2269,9667,2023,2187,9366,2605,4456,19033,4628,28117,13959,14158,0.4965,0.5035,0.1585,0.6769,0.1646,3083.0
738,2019,Santa Bàrbara,79,28.15,Montsià,Costal,Amposta,12,Tarragona,280,1225,376,273,1125,428,553,2350,804,3707,1881,1826,0.5074,0.4926,0.1492,0.6339,0.2169,131.69
739,2019,Santa Cecília de Voltregà,519,8.63,Osona,Interior,Vic,50,Barcelona,11,68,20,12,60,16,23,128,36,187,99,88,0.5294,0.4706,0.123,0.6845,0.1925,21.67
740,2019,Santa Coloma de Cervelló,73,7.49,Baix Llobregat,Costal,St. Feliu de Llobregat,30,Barcelona,792,2741,493,826,2760,606,1618,5501,1099,8218,4026,4192,0.4899,0.5101,0.1969,0.6694,0.1337,1097.2
741,2019,Santa Coloma de Farners,142,70.64,Selva,Costal,Sta. Coloma de Farners,26,Girona,1126,4516,979,1136,4177,1209,2262,8693,2188,13143,6621,6522,0.5038,0.4962,0.1721,0.6614,0.1665,186.06
742,2019,Santa Coloma de Gramenet,56,7.0,Barcelonès,Costal,Barcelona,5,Barcelona,9451,39528,9916,8881,37958,13481,18332,77486,23397,119215,58895,60320,0.494,0.506,0.1538,0.65,0.1963,17030.71
743,2019,Santa Coloma de Queralt,674,33.85,Conca de Barberà,Interior,Montblanc,22,Tarragona,205,852,271,179,799,367,384,1651,638,2673,1328,1345,0.4968,0.5032,0.1437,0.6177,0.2387,78.97
744,2019,Santa Cristina d'Aro,30,67.55,Baix Empordà,Costal,"Bisbal d'Empordà, la",36,Girona,414,1775,435,432,1674,493,846,3449,928,5223,2624,2599,0.5024,0.4976,0.162,0.6603,0.1777,77.32
745,2019,Santa Eugènia de Berga,538,7.01,Osona,Interior,Vic,50,Barcelona,173,776,193,154,742,210,327,1518,403,2248,1142,1106,0.508,0.492,0.1455,0.6753,0.1793,320.68
746,2019,Santa Eulàlia de Riuprimer,568,13.82,Osona,Interior,Vic,50,Barcelona,143,448,95,132,411,116,275,859,211,1345,686,659,0.51,0.49,0.2045,0.6387,0.1569,97.32
747,2019,Santa Eulàlia de Ronçana,236,14.23,Vallès Oriental,Interior,Granollers,39,Barcelona,623,2441,575,598,2367,684,1221,4808,1259,7288,3639,3649,0.4993,0.5007,0.1675,0.6597,0.1727,512.16
748,2019,Santa Fe del Penedès,240,3.4,Alt Penedès,Interior,Vilafranca del Penedès,27,Barcelona,31,127,27,30,126,33,61,253,60,374,185,189,0.4947,0.5053,0.1631,0.6765,0.1604,110.0
749,2019,Santa Llogaia d'Àlguema,42,1.94,Alt Empordà,Costal,Figueres,68,Girona,38,126,25,40,108,33,78,234,58,370,189,181,0.5108,0.4892,0.2108,0.6324,0.1568,190.72
750,2019,Santa Margarida de Montbui,316,27.59,Anoia,Interior,Igualada,33,Barcelona,913,3304,776,849,3175,963,1762,6479,1739,9980,4993,4987,0.5003,0.4997,0.1766,0.6492,0.1742,361.73
751,2019,Santa Margarida i els Monjos,161,17.16,Alt Penedès,Interior,Vilafranca del Penedès,27,Barcelona,768,2583,505,736,2435,584,1504,5018,1089,7611,3856,3755,0.5066,0.4934,0.1976,0.6593,0.1431,443.53
752,2019,Santa Maria d'Oló,542,66.21,Moianès,Interior,Moià,10,Barcelona,84,324,113,66,299,139,150,623,252,1025,521,504,0.5083,0.4917,0.1463,0.6078,0.2459,15.48
753,2019,Santa Maria de Besora,866,24.73,Osona,Interior,Vic,50,Barcelona,10,52,16,9,39,24,19,91,40,150,78,72,0.52,0.48,0.1267,0.6067,0.2667,6.07
754,2019,Santa Maria de Martorelles,181,4.51,Vallès Oriental,Interior,Granollers,39,Barcelona,80,311,58,76,287,81,156,598,139,893,449,444,0.5028,0.4972,0.1747,0.6697,0.1557,198.0
755,2019,Santa Maria de Merlès,532,52.08,Berguedà,Pre-Pirineu,Berga,31,Barcelona,17,60,12,23,56,16,40,116,28,184,89,95,0.4837,0.5163,0.2174,0.6304,0.1522,3.53
756,2019,Santa Maria de Miralles,543,25.04,Anoia,Interior,Igualada,33,Barcelona,7,45,16,8,34,16,15,79,32,126,68,58,0.5397,0.4603,0.119,0.627,0.254,5.03
757,2019,Santa Maria de Palautordera,208,16.94,Vallès Oriental,Interior,Granollers,39,Barcelona,791,3266,703,714,3089,860,1505,6355,1563,9423,4760,4663,0.5051,0.4949,0.1597,0.6744,0.1659,556.26
758,2019,Santa Oliva,101,9.65,Baix Penedès,Costal,"Vendrell, el",14,Tarragona,303,1098,284,274,1032,329,577,2130,613,3320,1685,1635,0.5075,0.4925,0.1738,0.6416,0.1846,344.04
759,2019,Santa Pau,496,49.01,Garrotxa,Pre-Pirineu,Olot,21,Girona,119,501,172,101,490,182,220,991,354,1565,792,773,0.5061,0.4939,0.1406,0.6332,0.2262,31.93
760,2019,Tivissa,309,209.43,Ribera d'Ebre,Interior,Móra d'Ebre,14,Tarragona,106,499,194,82,490,231,188,989,425,1602,799,803,0.4988,0.5012,0.1174,0.6174,0.2653,7.65
761,2019,Santa Perpètua de Mogoda,74,15.83,Vallès Occidental,Interior,Sabadell i Terrassa,23,Barcelona,2380,8847,1731,2183,8499,2159,4563,17346,3890,25799,12958,12841,0.5023,0.4977,0.1769,0.6724,0.1508,1629.75
762,2019,Santa Susanna,10,12.63,Maresme,Costal,Mataró,30,Barcelona,305,1151,265,292,1123,310,597,2274,575,3446,1721,1725,0.4994,0.5006,0.1732,0.6599,0.1669,272.84
763,2019,Santpedor,336,16.59,Bages,Interior,Manresa,30,Barcelona,754,2391,610,648,2423,728,1402,4814,1338,7554,3755,3799,0.4971,0.5029,0.1856,0.6373,0.1771,455.33
764,2019,Sarral,467,52.39,Conca de Barberà,Interior,Montblanc,22,Tarragona,111,530,148,137,458,164,248,988,312,1548,789,759,0.5097,0.4903,0.1602,0.6382,0.2016,29.55
765,2019,Sarrià de Ter,70,4.16,Gironès,Interior,Girona,27,Girona,446,1709,375,439,1707,494,885,3416,869,5170,2530,2640,0.4894,0.5106,0.1712,0.6607,0.1681,1242.79
766,2019,Sarroca de Bellera,1002,87.51,Pallars Jussà,Pre-Pirineu,Tremp,14,Lleida,1,42,25,5,30,18,6,72,43,121,68,53,0.562,0.438,0.0496,0.595,0.3554,1.38
767,2019,Sarroca de Lleida,201,42.18,Segrià,Costal,Lleida,38,Lleida,18,113,69,14,89,60,32,202,129,363,200,163,0.551,0.449,0.0882,0.5565,0.3554,8.61
768,2019,"Saus, Camallera i Llampaies",86,11.36,Alt Empordà,Costal,Figueres,68,Girona,64,271,89,62,248,103,126,519,192,837,424,413,0.5066,0.4934,0.1505,0.6201,0.2294,73.68
769,2019,Savallà del Comtat,825,14.8,Conca de Barberà,Interior,Montblanc,22,Tarragona,1,22,8,0,17,10,1,39,18,58,31,27,0.5345,0.4655,0.0172,0.6724,0.3103,3.92
770,2019,"Secuita, la",169,17.77,Tarragonès,Costal,Tarragona,22,Tarragona,142,580,129,151,542,143,293,1122,272,1687,851,836,0.5044,0.4956,0.1737,0.6651,0.1612,94.94
771,2019,"Selva de Mar, la",48,7.19,Alt Empordà,Costal,Figueres,68,Girona,8,69,31,5,55,28,13,124,59,196,108,88,0.551,0.449,0.0663,0.6327,0.301,27.26
772,2019,"Selva del Camp, la",246,35.31,Baix Camp,Costal,Reus,28,Tarragona,490,1941,405,460,1852,504,950,3793,909,5652,2836,2816,0.5018,0.4982,0.1681,0.6711,0.1608,160.07
773,2019,Senan,652,11.7,Conca de Barberà,Interior,Montblanc,22,Tarragona,3,18,12,3,9,3,6,27,15,48,33,15,0.6875,0.3125,0.125,0.5625,0.3125,4.1
774,2019,"Sénia, la",369,108.41,Montsià,Costal,Amposta,12,Tarragona,412,1904,528,394,1803,640,806,3707,1168,5681,2844,2837,0.5006,0.4994,0.1419,0.6525,0.2056,52.4
775,2019,Senterada,729,34.45,Pallars Jussà,Pre-Pirineu,Tremp,14,Lleida,4,65,11,6,40,11,10,105,22,137,80,57,0.5839,0.4161,0.073,0.7664,0.1606,3.98
776,2019,"Sentiu de Sió, la",281,29.62,Noguera,Interior,Balaguer,30,Lleida,17,138,61,19,115,56,36,253,117,406,216,190,0.532,0.468,0.0887,0.6232,0.2882,13.71
777,2019,Sentmenat,207,28.8,Vallès Occidental,Interior,Sabadell i Terrassa,23,Barcelona,852,3153,606,756,3016,695,1608,6169,1301,9078,4611,4467,0.5079,0.4921,0.1771,0.6796,0.1433,315.21
778,2019,Serinyà,188,17.38,Pla de l'Estany,Interior,Banyoles,11,Girona,109,372,95,92,363,105,201,735,200,1136,576,560,0.507,0.493,0.1769,0.647,0.1761,65.36
779,2019,Seròs,103,85.75,Segrià,Costal,Lleida,38,Lleida,140,700,189,140,529,224,280,1229,413,1922,1029,893,0.5354,0.4646,0.1457,0.6394,0.2149,22.41
780,2019,Serra de Daró,15,7.91,Baix Empordà,Costal,"Bisbal d'Empordà, la",36,Girona,18,79,25,15,59,25,33,138,50,221,122,99,0.552,0.448,0.1493,0.6244,0.2262,27.94
781,2019,Setcases,1265,49.12,Ripollès,Pirineu,Ripoll,19,Girona,10,61,27,5,56,18,15,117,45,177,98,79,0.5537,0.4463,0.0847,0.661,0.2542,3.6
782,2019,"Seu d'Urgell, la",691,15.45,Alt Urgell,Pirineu,"Seu d'Urgell, la",19,Lleida,873,3976,993,872,4060,1315,1745,8036,2308,12089,5842,6247,0.4832,0.5168,0.1443,0.6647,0.1909,782.46
783,2019,Seva,663,30.4,Osona,Interior,Vic,50,Barcelona,300,1197,287,259,1134,342,559,2331,629,3519,1784,1735,0.507,0.493,0.1589,0.6624,0.1787,115.76
784,2019,Sidamon,232,8.12,Pla d'Urgell,Interior,Mollerussa,16,Lleida,68,261,54,49,228,74,117,489,128,734,383,351,0.5218,0.4782,0.1594,0.6662,0.1744,90.39
785,2019,Sils,76,29.91,Selva,Costal,Sta. Coloma de Farners,26,Girona,547,2086,475,488,1970,527,1035,4056,1002,6093,3108,2985,0.5101,0.4899,0.1699,0.6657,0.1645,203.71
786,2019,Sitges,10,43.85,Garraf,Costal,Vilanova i la Geltrú,6,Barcelona,2188,10075,2445,1974,9663,2962,4162,19738,5407,29307,14708,14599,0.5019,0.4981,0.142,0.6735,0.1845,668.35
787,2019,Siurana,33,10.53,Alt Empordà,Costal,Figueres,68,Girona,11,56,17,10,52,22,21,108,39,168,84,84,0.5,0.5,0.125,0.6429,0.2321,15.95
788,2019,Sobremunt,881,13.79,Osona,Interior,Vic,50,Barcelona,1,28,7,6,28,9,7,56,16,79,36,43,0.4557,0.5443,0.0886,0.7089,0.2025,5.73
789,2019,"Soleràs, el",381,12.23,Garrigues,Interior,"Borges Blanques, les",24,Lleida,15,110,48,20,80,59,35,190,107,332,173,159,0.5211,0.4789,0.1054,0.5723,0.3223,27.15
790,2019,Solivella,489,21.37,Conca de Barberà,Interior,Montblanc,22,Tarragona,47,203,83,27,182,91,74,385,174,633,333,300,0.5261,0.4739,0.1169,0.6082,0.2749,29.62
791,2019,Solsona,664,17.7,Solsonès,Pre-Pirineu,Solsona,15,Lleida,736,3032,720,730,2879,997,1466,5911,1717,9094,4488,4606,0.4935,0.5065,0.1612,0.65,0.1888,513.79
792,2019,Sora,716,31.73,Osona,Interior,Vic,50,Barcelona,22,71,24,13,60,19,35,131,43,209,117,92,0.5598,0.4402,0.1675,0.6268,0.2057,6.59
793,2019,Soriguera,1258,106.39,Pallars Sobirà,Pirineu,Sort,15,Lleida,37,151,32,22,136,32,59,287,64,410,220,190,0.5366,0.4634,0.1439,0.7,0.1561,3.85
794,2019,Sort,692,105.05,Pallars Sobirà,Pirineu,Sort,15,Lleida,172,720,185,153,702,217,325,1422,402,2149,1077,1072,0.5012,0.4988,0.1512,0.6617,0.1871,20.46
795,2019,Soses,118,30.16,Segrià,Costal,Lleida,38,Lleida,159,602,162,150,508,182,309,1110,344,1763,923,840,0.5235,0.4765,0.1753,0.6296,0.1951,58.45
796,2019,Subirats,243,55.9,Alt Penedès,Interior,Vilafranca del Penedès,27,Barcelona,257,1033,287,218,939,310,475,1972,597,3044,1577,1467,0.5181,0.4819,0.156,0.6478,0.1961,54.45
797,2019,Sudanell,152,8.69,Segrià,Costal,Lleida,38,Lleida,52,316,97,35,245,108,87,561,205,853,465,388,0.5451,0.4549,0.102,0.6577,0.2403,98.16
798,2019,Sunyer,211,12.66,Segrià,Costal,Lleida,38,Lleida,13,160,32,17,91,39,30,251,71,352,205,147,0.5824,0.4176,0.0852,0.7131,0.2017,27.8
799,2019,Súria,326,23.6,Bages,Interior,Manresa,30,Barcelona,392,1922,583,378,1866,801,770,3788,1384,5942,2897,3045,0.4875,0.5125,0.1296,0.6375,0.2329,251.78
800,2019,Susqueda,816,50.61,Selva,Costal,Sta. Coloma de Farners,26,Girona,2,47,11,6,27,8,8,74,19,101,60,41,0.5941,0.4059,0.0792,0.7327,0.1881,2.0
801,2019,Tagamanent,354,43.31,Vallès Oriental,Interior,Granollers,39,Barcelona,30,116,23,20,109,25,50,225,48,323,169,154,0.5232,0.4768,0.1548,0.6966,0.1486,7.46
802,2019,Talamanca,552,29.43,Bages,Interior,Manresa,30,Barcelona,17,74,24,14,58,19,31,132,43,206,115,91,0.5583,0.4417,0.1505,0.6408,0.2087,7.0
803,2019,Talarn,572,27.95,Pallars Jussà,Pre-Pirineu,Tremp,14,Lleida,25,316,46,26,131,41,51,447,87,585,387,198,0.6615,0.3385,0.0872,0.7641,0.1487,20.93
804,2019,Talavera,791,30.11,Segarra,Interior,Cervera,21,Lleida,16,97,45,11,69,45,27,166,90,283,158,125,0.5583,0.4417,0.0954,0.5866,0.318,9.4
805,2019,"Tallada d'Empordà, la",20,16.56,Baix Empordà,Costal,"Bisbal d'Empordà, la",36,Girona,33,153,55,34,140,48,67,293,103,463,241,222,0.5205,0.4795,0.1447,0.6328,0.2225,27.96
806,2019,Taradell,623,26.48,Osona,Interior,Vic,50,Barcelona,556,2121,561,492,2071,688,1048,4192,1249,6489,3238,3251,0.499,0.501,0.1615,0.646,0.1925,245.05
807,2019,Tarragona,68,57.88,Tarragonès,Costal,Tarragona,22,Tarragona,10794,44382,10329,10319,44640,14051,21113,89022,24380,134515,65505,69010,0.487,0.513,0.157,0.6618,0.1812,2324.03
808,2019,Tàrrega,373,88.36,Urgell,Interior,Tàrrega,20,Lleida,1561,5751,1177,1450,5592,1567,3011,11343,2744,17098,8489,8609,0.4965,0.5035,0.1761,0.6634,0.1605,193.5
809,2019,Tarrés,578,13.01,Garrigues,Interior,"Borges Blanques, les",24,Lleida,7,31,18,9,30,11,16,61,29,106,56,50,0.5283,0.4717,0.1509,0.5755,0.2736,8.15
810,2019,Tarroja de Segarra,460,7.61,Segarra,Interior,Cervera,21,Lleida,14,61,29,13,51,19,27,112,48,187,104,83,0.5561,0.4439,0.1444,0.5989,0.2567,24.57
811,2019,Tavèrnoles,537,18.76,Osona,Interior,Vic,50,Barcelona,25,107,27,27,96,34,52,203,61,316,159,157,0.5032,0.4968,0.1646,0.6424,0.193,16.84
812,2019,Tavertet,869,32.49,Osona,Interior,Vic,50,Barcelona,4,34,19,4,34,16,8,68,35,111,57,54,0.5135,0.4865,0.0721,0.6126,0.3153,3.42
813,2019,Teià,128,6.63,Maresme,Costal,Mataró,30,Barcelona,526,2038,570,434,2072,757,960,4110,1327,6397,3134,3263,0.4899,0.5101,0.1501,0.6425,0.2074,964.86
814,2019,Térmens,208,27.54,Noguera,Interior,Balaguer,30,Lleida,81,459,138,91,367,197,172,826,335,1333,678,655,0.5086,0.4914,0.129,0.6197,0.2513,48.4
815,2019,Terrades,228,20.96,Alt Empordà,Costal,Figueres,68,Girona,22,110,30,26,106,35,48,216,65,329,162,167,0.4924,0.5076,0.1459,0.6565,0.1976,15.7
816,2019,Terrassa,277,70.16,Vallès Occidental,Interior,Sabadell i Terrassa,23,Barcelona,19465,73501,15503,18227,72441,21419,37692,145942,36922,220556,108469,112087,0.4918,0.5082,0.1709,0.6617,0.1674,3143.61
817,2019,Tiana,136,7.95,Maresme,Costal,Mataró,30,Barcelona,723,2863,647,787,3029,791,1510,5892,1438,8840,4233,4607,0.4788,0.5212,0.1708,0.6665,0.1627,1111.95
818,2019,Tírvia,991,8.5,Pallars Sobirà,Pirineu,Sort,15,Lleida,3,43,17,6,44,18,9,87,35,131,63,68,0.4809,0.5191,0.0687,0.6641,0.2672,15.41
819,2019,Tiurana,387,15.86,Noguera,Interior,Balaguer,30,Lleida,3,20,10,3,27,10,6,47,20,73,33,40,0.4521,0.5479,0.0822,0.6438,0.274,4.6
820,2019,Tivenys,13,53.54,Baix Ebre,Costal,Tortosa,14,Tarragona,38,301,119,45,246,150,83,547,269,899,458,441,0.5095,0.4905,0.0923,0.6085,0.2992,16.79
821,2019,Tona,596,16.54,Osona,Interior,Vic,50,Barcelona,687,2781,631,665,2670,807,1352,5451,1438,8241,4099,4142,0.4974,0.5026,0.1641,0.6614,0.1745,498.25
822,2019,Torà,448,93.31,Segarra,Interior,Cervera,21,Lleida,80,433,126,77,385,154,157,818,280,1255,639,616,0.5092,0.4908,0.1251,0.6518,0.2231,13.45
823,2019,Tordera,34,84.09,Maresme,Costal,Mataró,30,Barcelona,1556,5821,1345,1412,5502,1580,2968,11323,2925,17216,8722,8494,0.5066,0.4934,0.1724,0.6577,0.1699,204.73
824,2019,Torelló,508,13.48,Osona,Interior,Vic,50,Barcelona,1167,4763,1207,1130,4515,1565,2297,9278,2772,14347,7137,7210,0.4975,0.5025,0.1601,0.6467,0.1932,1064.32
825,2019,"Torms, els",476,13.75,Garrigues,Interior,"Borges Blanques, les",24,Lleida,8,47,22,2,36,29,10,83,51,144,77,67,0.5347,0.4653,0.0694,0.5764,0.3542,10.47
826,2019,Tornabous,289,24.17,Urgell,Interior,Tàrrega,20,Lleida,66,290,105,49,231,117,115,521,222,858,461,397,0.5373,0.4627,0.134,0.6072,0.2587,35.5
827,2019,"Torre de Cabdella, la",1075,165.27,Pallars Jussà,Pre-Pirineu,Tremp,14,Lleida,32,251,100,28,218,131,60,469,231,760,383,377,0.5039,0.4961,0.0789,0.6171,0.3039,4.6
828,2019,"Torre de Claramunt, la",363,15.02,Anoia,Interior,Igualada,33,Barcelona,316,1313,294,273,1216,302,589,2529,596,3714,1923,1791,0.5178,0.4822,0.1586,0.6809,0.1605,247.27
829,2019,"Torre de Fontaubella, la",369,7.11,Priorat,Interior,Falset,23,Tarragona,12,35,21,8,38,24,20,73,45,138,68,70,0.4928,0.5072,0.1449,0.529,0.3261,19.41
830,2019,"Torre de l'Espanyol, la",164,27.9,Ribera d'Ebre,Interior,Móra d'Ebre,14,Tarragona,36,197,78,41,177,82,77,374,160,611,311,300,0.509,0.491,0.126,0.6121,0.2619,21.9
831,2019,Torrebesses,287,27.45,Segrià,Costal,Lleida,38,Lleida,17,93,40,16,71,45,33,164,85,282,150,132,0.5319,0.4681,0.117,0.5816,0.3014,10.27
832,2019,Torredembarra,15,8.71,Tarragonès,Costal,Tarragona,22,Tarragona,1243,5318,1364,1243,5313,1703,2486,10631,3067,16184,7925,8259,0.4897,0.5103,0.1536,0.6569,0.1895,1858.09
833,2019,Torrefarrera,214,23.49,Segrià,Costal,Lleida,38,Lleida,484,1589,255,444,1524,309,928,3113,564,4605,2328,2277,0.5055,0.4945,0.2015,0.676,0.1225,196.04
834,2019,Torrefeta i Florejacs,475,88.91,Segarra,Interior,Cervera,21,Lleida,36,213,73,29,170,81,65,383,154,602,322,280,0.5349,0.4651,0.108,0.6362,0.2558,6.77
835,2019,Torregrossa,232,40.52,Pla d'Urgell,Interior,Mollerussa,16,Lleida,156,748,236,140,630,292,296,1378,528,2202,1140,1062,0.5177,0.4823,0.1344,0.6258,0.2398,54.34
836,2019,Torrelameu,201,10.93,Noguera,Interior,Balaguer,30,Lleida,46,312,75,46,181,83,92,493,158,743,433,310,0.5828,0.4172,0.1238,0.6635,0.2127,67.98
837,2019,Torrelavit,202,23.65,Alt Penedès,Interior,Vilafranca del Penedès,27,Barcelona,119,470,134,126,439,131,245,909,265,1419,723,696,0.5095,0.4905,0.1727,0.6406,0.1868,60.0
838,2019,Torrelles de Foix,367,36.72,Alt Penedès,Interior,Vilafranca del Penedès,27,Barcelona,188,872,207,154,710,217,342,1582,424,2348,1267,1081,0.5396,0.4604,0.1457,0.6738,0.1806,63.94
839,2019,Torrelles de Llobregat,126,13.56,Baix Llobregat,Costal,St. Feliu de Llobregat,30,Barcelona,555,2091,357,560,2050,428,1115,4141,785,6041,3003,3038,0.4971,0.5029,0.1846,0.6855,0.1299,445.5
840,2019,Torrent,44,7.96,Baix Empordà,Costal,"Bisbal d'Empordà, la",36,Girona,9,63,20,12,51,20,21,114,40,175,92,83,0.5257,0.4743,0.12,0.6514,0.2286,21.98
841,2019,Torres de Segre,119,50.61,Segrià,Costal,Lleida,38,Lleida,126,852,201,146,726,226,272,1578,427,2277,1179,1098,0.5178,0.4822,0.1195,0.693,0.1875,44.99
842,2019,Torre-serona,197,5.89,Segrià,Costal,Lleida,38,Lleida,18,153,37,25,114,50,43,267,87,397,208,189,0.5239,0.4761,0.1083,0.6725,0.2191,67.4
843,2019,Torroella de Fluvià,9,16.85,Alt Empordà,Costal,Figueres,68,Girona,48,252,54,56,226,58,104,478,112,694,354,340,0.5101,0.4899,0.1499,0.6888,0.1614,41.19
844,2019,Torroella de Montgrí,31,65.93,Baix Empordà,Costal,"Bisbal d'Empordà, la",36,Girona,961,3947,992,880,3741,1124,1841,7688,2116,11645,5900,5745,0.5067,0.4933,0.1581,0.6602,0.1817,176.63
845,2019,Torroja del Priorat,332,13.16,Priorat,Interior,Falset,23,Tarragona,9,48,24,3,40,25,12,88,49,149,81,68,0.5436,0.4564,0.0805,0.5906,0.3289,11.32
846,2019,Tortellà,276,11.07,Garrotxa,Pre-Pirineu,Olot,21,Girona,59,253,81,65,257,94,124,510,175,809,393,416,0.4858,0.5142,0.1533,0.6304,0.2163,73.08
847,2019,Tortosa,12,218.51,Baix Ebre,Costal,Tortosa,14,Tarragona,2592,10950,2954,2526,10439,3911,5118,21389,6865,33372,16496,16876,0.4943,0.5057,0.1534,0.6409,0.2057,152.73
848,2019,Toses,1444,57.88,Ripollès,Pirineu,Ripoll,19,Girona,9,70,23,11,45,13,20,115,36,171,102,69,0.5965,0.4035,0.117,0.6725,0.2105,2.95
849,2019,Tossa de Mar,5,38.58,Selva,Costal,Sta. Coloma de Farners,26,Girona,366,1992,503,367,1848,607,733,3840,1110,5683,2861,2822,0.5034,0.4966,0.129,0.6757,0.1953,147.3
850,2019,Tremp,468,302.82,Pallars Jussà,Pre-Pirineu,Tremp,14,Lleida,406,1924,554,397,1790,773,803,3714,1327,5844,2884,2960,0.4935,0.5065,0.1374,0.6355,0.2271,19.3
851,2019,Ullà,21,7.29,Baix Empordà,Costal,"Bisbal d'Empordà, la",36,Girona,110,442,80,108,329,84,218,771,164,1153,632,521,0.5481,0.4519,0.1891,0.6687,0.1422,158.16
852,2019,Ullastrell,342,7.31,Vallès Occidental,Interior,Sabadell i Terrassa,23,Barcelona,224,700,128,205,678,158,429,1378,286,2093,1052,1041,0.5026,0.4974,0.205,0.6584,0.1366,286.32
853,2019,Ullastret,49,11.09,Baix Empordà,Costal,"Bisbal d'Empordà, la",36,Girona,18,90,32,29,91,30,47,181,62,290,140,150,0.4828,0.5172,0.1621,0.6241,0.2138,26.15
854,2019,Ulldecona,133,126.88,Montsià,Costal,Amposta,12,Tarragona,486,2210,590,445,1881,688,931,4091,1278,6300,3286,3014,0.5216,0.4784,0.1478,0.6494,0.2029,49.65
855,2019,Ulldemolins,650,38.17,Priorat,Interior,Falset,23,Tarragona,16,143,70,13,88,66,29,231,136,396,229,167,0.5783,0.4217,0.0732,0.5833,0.3434,10.37
856,2019,Ultramort,30,4.35,Baix Empordà,Costal,"Bisbal d'Empordà, la",36,Girona,25,65,28,16,58,31,41,123,59,223,118,105,0.5291,0.4709,0.1839,0.5516,0.2646,51.26
857,2019,Urús,1263,17.42,Cerdanya,Pirineu,Puigcerdà,17,Girona,8,70,15,7,66,23,15,136,38,189,93,96,0.4921,0.5079,0.0794,0.7196,0.2011,10.85
858,2019,Vacarisses,382,40.7,Vallès Occidental,Interior,Sabadell i Terrassa,23,Barcelona,696,2335,405,593,2219,440,1289,4554,845,6688,3436,3252,0.5138,0.4862,0.1927,0.6809,0.1263,164.32
859,2019,"Vajol, la",546,4.71,Alt Empordà,Costal,Figueres,68,Girona,6,32,10,3,27,11,9,59,21,89,48,41,0.5393,0.4607,0.1011,0.6629,0.236,18.9
860,2019,"Vall d'en Bas, la",510,90.67,Garrotxa,Pre-Pirineu,Olot,21,Girona,264,997,292,230,952,337,494,1949,629,3072,1553,1519,0.5055,0.4945,0.1608,0.6344,0.2048,33.88
861,2019,"Vall de Bianya, la",367,93.62,Garrotxa,Pre-Pirineu,Olot,21,Girona,99,433,107,98,404,123,197,837,230,1264,639,625,0.5055,0.4945,0.1559,0.6622,0.182,13.5
862,2019,"Vall de Boí, la",1111,219.49,Alta Ribagorça,Pirineu,"Pont de Suert, el",3,Lleida,70,378,98,63,334,78,133,712,176,1021,546,475,0.5348,0.4652,0.1303,0.6974,0.1724,4.65
863,2019,Vall de Cardós,898,56.2,Pallars Sobirà,Pirineu,Sort,15,Lleida,19,136,40,28,100,41,47,236,81,364,195,169,0.5357,0.4643,0.1291,0.6484,0.2225,6.48
864,2019,Vallbona d'Anoia,289,6.45,Anoia,Interior,Igualada,33,Barcelona,120,469,130,84,425,145,204,894,275,1373,719,654,0.5237,0.4763,0.1486,0.6511,0.2003,212.87
865,2019,Vallbona de les Monges,481,34.14,Urgell,Interior,Tàrrega,20,Lleida,6,79,35,13,52,48,19,131,83,233,120,113,0.515,0.485,0.0815,0.5622,0.3562,6.82
866,2019,Vallcebre,1123,27.99,Berguedà,Pre-Pirineu,Berga,31,Barcelona,4,97,41,9,64,35,13,161,76,250,142,108,0.568,0.432,0.052,0.644,0.304,8.93
867,2019,Vallclara,625,13.63,Conca de Barberà,Interior,Montblanc,22,Tarragona,8,37,12,5,26,10,13,63,22,98,57,41,0.5816,0.4184,0.1327,0.6429,0.2245,7.19
868,2019,Vallfogona de Balaguer,235,26.97,Noguera,Interior,Balaguer,30,Lleida,161,607,169,164,595,180,325,1202,349,1876,937,939,0.4995,0.5005,0.1732,0.6407,0.186,69.56
869,2019,Vallfogona de Ripollès,956,39.2,Ripollès,Pirineu,Ripoll,19,Girona,11,66,32,9,53,35,20,119,67,206,109,97,0.5291,0.4709,0.0971,0.5777,0.3252,5.26
870,2019,Vallfogona de Riucorb,573,10.94,Conca de Barberà,Interior,Montblanc,22,Tarragona,1,35,19,0,18,18,1,53,37,91,55,36,0.6044,0.3956,0.011,0.5824,0.4066,8.32
871,2019,Vallgorguina,222,22.13,Vallès Oriental,Interior,Granollers,39,Barcelona,299,985,167,296,961,183,595,1946,350,2891,1451,1440,0.5019,0.4981,0.2058,0.6731,0.1211,130.64
872,2019,Vallirana,177,23.88,Baix Llobregat,Costal,St. Feliu de Llobregat,30,Barcelona,1295,5039,1189,1266,4852,1365,2561,9891,2554,15006,7523,7483,0.5013,0.4987,0.1707,0.6591,0.1702,628.39
873,2019,Vall-llobrega,49,5.45,Baix Empordà,Costal,"Bisbal d'Empordà, la",36,Girona,83,313,50,88,311,54,171,624,104,899,446,453,0.4961,0.5039,0.1902,0.6941,0.1157,164.95
874,2019,Vallmoll,161,16.68,Alt Camp,Interior,Valls,23,Tarragona,138,608,144,139,572,155,277,1180,299,1756,890,866,0.5068,0.4932,0.1577,0.672,0.1703,105.28
875,2019,Vallromanes,153,10.65,Vallès Oriental,Interior,Granollers,39,Barcelona,269,906,153,225,867,159,494,1773,312,2579,1328,1251,0.5149,0.4851,0.1915,0.6875,0.121,242.16
876,2019,Valls,215,55.28,Alt Camp,Interior,Valls,23,Tarragona,1991,8261,1958,1883,7752,2514,3874,16013,4472,24359,12210,12149,0.5013,0.4987,0.159,0.6574,0.1836,440.65
877,2019,"Valls d'Aguilar, les",669,123.81,Alt Urgell,Pirineu,"Seu d'Urgell, la",19,Lleida,10,88,47,8,76,31,18,164,78,260,145,115,0.5577,0.4423,0.0692,0.6308,0.3,2.1
878,2019,"Valls de Valira, les",740,171.25,Alt Urgell,Pirineu,"Seu d'Urgell, la",19,Lleida,52,281,79,43,257,79,95,538,158,791,412,379,0.5209,0.4791,0.1201,0.6802,0.1997,4.62
879,2019,Vandellòs i l'Hospitalet de l'Infant,281,102.67,Baix Camp,Costal,Reus,28,Tarragona,572,2177,497,526,2116,594,1098,4293,1091,6482,3246,3236,0.5008,0.4992,0.1694,0.6623,0.1683,63.13
880,2019,"Vansa i Fórnols, la",989,106.08,Alt Urgell,Pirineu,"Seu d'Urgell, la",19,Lleida,2,60,22,3,48,26,5,108,48,161,84,77,0.5217,0.4783,0.0311,0.6708,0.2981,1.52
881,2019,Veciana,564,38.9,Anoia,Interior,Igualada,33,Barcelona,18,52,29,17,44,22,35,96,51,182,99,83,0.544,0.456,0.1923,0.5275,0.2802,4.68
882,2019,"Vendrell, el",49,36.8,Baix Penedès,Costal,"Vendrell, el",14,Tarragona,3169,12234,3228,3021,12186,3768,6190,24420,6996,37606,18631,18975,0.4954,0.5046,0.1646,0.6494,0.186,1021.9
883,2019,Ventalló,28,25.05,Alt Empordà,Costal,Figueres,68,Girona,69,283,86,65,264,92,134,547,178,859,438,421,0.5099,0.4901,0.156,0.6368,0.2072,34.29
884,2019,Verdú,434,35.79,Urgell,Interior,Tàrrega,20,Lleida,54,290,97,58,267,153,112,557,250,919,441,478,0.4799,0.5201,0.1219,0.6061,0.272,25.68
885,2019,Verges,23,9.7,Baix Empordà,Costal,"Bisbal d'Empordà, la",36,Girona,93,357,122,104,332,163,197,689,285,1171,572,599,0.4885,0.5115,0.1682,0.5884,0.2434,120.72
886,2019,Vespella de Gaià,191,18.04,Tarragonès,Costal,Tarragona,22,Tarragona,33,143,56,30,111,37,63,254,93,410,232,178,0.5659,0.4341,0.1537,0.6195,0.2268,22.73
887,2019,Vic,484,30.58,Osona,Interior,Vic,50,Barcelona,4198,16223,2885,3827,14823,4258,8025,31046,7143,46214,23306,22908,0.5043,0.4957,0.1736,0.6718,0.1546,1511.25
888,2019,Vidrà,982,34.39,Osona,Interior,Vic,50,Barcelona,11,56,16,11,58,15,22,114,31,167,83,84,0.497,0.503,0.1317,0.6826,0.1856,4.86
889,2019,Vidreres,93,48.05,Selva,Costal,Sta. Coloma de Farners,26,Girona,638,2752,658,575,2452,722,1213,5204,1380,7797,4048,3749,0.5192,0.4808,0.1556,0.6674,0.177,162.27
890,2019,Vielha e Mijaran,974,211.74,Val d'Aran,Pirineu,Vielha,9,Lleida,409,2110,318,366,1955,401,775,4065,719,5559,2837,2722,0.5103,0.4897,0.1394,0.7312,0.1293,26.25
891,2019,Vilabella,254,18.19,Alt Camp,Interior,Valls,23,Tarragona,43,249,86,44,214,100,87,463,186,736,378,358,0.5136,0.4864,0.1182,0.6291,0.2527,40.46
892,2019,Vilabertran,19,2.29,Alt Empordà,Costal,Figueres,68,Girona,104,287,98,80,304,106,184,591,204,979,489,490,0.4995,0.5005,0.1879,0.6037,0.2084,427.51
893,2019,Vilablareix,99,6.17,Gironès,Interior,Girona,27,Girona,277,946,215,261,973,225,538,1919,440,2897,1438,1459,0.4964,0.5036,0.1857,0.6624,0.1519,469.53
894,2019,Vilada,757,22.34,Berguedà,Pre-Pirineu,Berga,31,Barcelona,16,137,64,11,114,74,27,251,138,416,217,199,0.5216,0.4784,0.0649,0.6034,0.3317,18.62
895,2019,Viladamat,13,11.73,Alt Empordà,Costal,Figueres,68,Girona,32,155,54,36,139,52,68,294,106,468,241,227,0.515,0.485,0.1453,0.6282,0.2265,39.9
896,2019,Viladasens,96,15.74,Gironès,Interior,Girona,27,Girona,20,71,16,8,61,24,28,132,40,200,107,93,0.535,0.465,0.14,0.66,0.2,12.71
897,2019,Viladecans,18,20.4,Baix Llobregat,Costal,St. Feliu de Llobregat,30,Barcelona,5905,22243,4782,5503,22064,6114,11408,44307,10896,66611,32930,33681,0.4944,0.5056,0.1713,0.6652,0.1636,3265.25
898,2019,Viladecavalls,274,20.09,Vallès Occidental,Interior,Sabadell i Terrassa,23,Barcelona,606,2609,509,604,2617,567,1210,5226,1076,7512,3724,3788,0.4957,0.5043,0.1611,0.6957,0.1432,373.92
899,2019,Vilademuls,120,61.54,Pla de l'Estany,Interior,Banyoles,11,Girona,75,266,83,66,252,73,141,518,156,815,424,391,0.5202,0.4798,0.173,0.6356,0.1914,13.24
900,2019,Viladrau,821,50.73,Osona,Interior,Vic,50,Barcelona,73,351,85,84,331,116,157,682,201,1040,509,531,0.4894,0.5106,0.151,0.6558,0.1933,20.5
901,2019,Vilafant,54,8.36,Alt Empordà,Costal,Figueres,68,Girona,453,1750,433,412,1806,540,865,3556,973,5394,2636,2758,0.4887,0.5113,0.1604,0.6593,0.1804,645.22
902,2019,Vilafranca del Penedès,223,19.65,Alt Penedès,Interior,Vilafranca del Penedès,27,Barcelona,3559,12800,2982,3336,13010,4059,6895,25810,7041,39746,19341,20405,0.4866,0.5134,0.1735,0.6494,0.1771,2022.7
903,2019,Vilagrassa,355,19.87,Urgell,Interior,Tàrrega,20,Lleida,46,186,46,44,170,49,90,356,95,541,278,263,0.5139,0.4861,0.1664,0.658,0.1756,27.23
904,2019,Vilajuïga,31,13.13,Alt Empordà,Costal,Figueres,68,Girona,73,386,90,83,374,98,156,760,188,1104,549,555,0.4973,0.5027,0.1413,0.6884,0.1703,84.08
905,2019,Vilalba dels Arcs,450,67.25,Terra Alta,Interior,Gandesa,12,Tarragona,32,193,93,35,161,111,67,354,204,625,318,307,0.5088,0.4912,0.1072,0.5664,0.3264,9.29
906,2019,Vilalba Sasserra,200,6.05,Vallès Oriental,Interior,Granollers,39,Barcelona,61,248,48,60,231,68,121,479,116,716,357,359,0.4986,0.5014,0.169,0.669,0.162,118.35
907,2019,Vilaller,981,59.23,Alta Ribagorça,Pirineu,"Pont de Suert, el",3,Lleida,38,198,58,30,161,76,68,359,134,561,294,267,0.5241,0.4759,0.1212,0.6399,0.2389,9.47
908,2019,Vilallonga de Ter,1067,64.2,Ripollès,Pirineu,Ripoll,19,Girona,21,144,47,21,113,52,42,257,99,398,212,186,0.5327,0.4673,0.1055,0.6457,0.2487,6.2
909,2019,Vilallonga del Camp,124,9.04,Tarragonès,Costal,Tarragona,22,Tarragona,264,793,149,234,774,175,498,1567,324,2389,1206,1183,0.5048,0.4952,0.2085,0.6559,0.1356,264.27
910,2019,Vilamacolum,5,5.57,Alt Empordà,Costal,Figueres,68,Girona,28,131,34,26,89,40,54,220,74,348,193,155,0.5546,0.4454,0.1552,0.6322,0.2126,62.48
911,2019,Vilamalla,45,8.77,Alt Empordà,Costal,Figueres,68,Girona,100,384,102,106,377,112,206,761,214,1181,586,595,0.4962,0.5038,0.1744,0.6444,0.1812,134.66
912,2019,Vilamaniscle,169,5.46,Alt Empordà,Costal,Figueres,68,Girona,17,74,25,11,55,18,28,129,43,200,116,84,0.58,0.42,0.14,0.645,0.215,36.63
913,2019,Vilamòs,1255,15.44,Val d'Aran,Pirineu,Vielha,9,Lleida,9,80,11,11,63,13,20,143,24,187,100,87,0.5348,0.4652,0.107,0.7647,0.1283,12.11
914,2019,Vilanant,98,16.87,Alt Empordà,Costal,Figueres,68,Girona,29,134,34,35,123,37,64,257,71,392,197,195,0.5026,0.4974,0.1633,0.6556,0.1811,23.24
915,2019,Vilanova d'Escornalbou,226,17.16,Baix Camp,Costal,Reus,28,Tarragona,42,182,64,45,160,52,87,342,116,545,288,257,0.5284,0.4716,0.1596,0.6275,0.2128,31.76
916,2019,Vilanova de Bellpuig,290,13.98,Pla d'Urgell,Interior,Mollerussa,16,Lleida,88,359,152,87,287,208,175,646,360,1181,599,582,0.5072,0.4928,0.1482,0.547,0.3048,84.48
917,2019,Vilanova de l'Aguda,409,53.68,Noguera,Interior,Balaguer,30,Lleida,7,59,31,6,61,33,13,120,64,197,97,100,0.4924,0.5076,0.066,0.6091,0.3249,3.67
918,2019,Vilanova de la Barca,195,21.55,Segrià,Costal,Lleida,38,Lleida,73,358,104,55,311,135,128,669,239,1036,535,501,0.5164,0.4836,0.1236,0.6458,0.2307,48.07
919,2019,Vilanova de Meià,633,105.24,Noguera,Interior,Balaguer,30,Lleida,22,129,72,19,88,59,41,217,131,389,223,166,0.5733,0.4267,0.1054,0.5578,0.3368,3.7
920,2019,Vilanova de Prades,893,21.51,Conca de Barberà,Interior,Montblanc,22,Tarragona,9,35,16,6,37,9,15,72,25,112,60,52,0.5357,0.4643,0.1339,0.6429,0.2232,5.21
921,2019,Vilanova de Sau,558,58.84,Osona,Interior,Vic,50,Barcelona,20,80,42,14,100,43,34,180,85,299,142,157,0.4749,0.5251,0.1137,0.602,0.2843,5.08
922,2019,Vilanova de Segrià,255,8.51,Segrià,Costal,Lleida,38,Lleida,77,349,92,64,293,102,141,642,194,977,518,459,0.5302,0.4698,0.1443,0.6571,0.1986,114.81
923,2019,Vilanova del Camí,302,10.28,Anoia,Interior,Igualada,33,Barcelona,1089,4233,905,1077,4001,1153,2166,8234,2058,12458,6227,6231,0.4998,0.5002,0.1739,0.6609,0.1652,1211.87
924,2019,Vilanova del Vallès,91,15.2,Vallès Oriental,Interior,Granollers,39,Barcelona,582,1866,312,528,1797,347,1110,3663,659,5432,2760,2672,0.5081,0.4919,0.2043,0.6743,0.1213,357.37
925,2019,Vilanova i la Geltrú,22,33.99,Garraf,Costal,Vilanova i la Geltrú,6,Barcelona,5093,21877,5486,4852,22479,7299,9945,44356,12785,67086,32456,34630,0.4838,0.5162,0.1482,0.6612,0.1906,1973.7
926,2019,Vilaplana,366,23.2,Baix Camp,Costal,Reus,28,Tarragona,30,209,63,31,181,60,61,390,123,574,302,272,0.5261,0.4739,0.1063,0.6794,0.2143,24.74
927,2019,Vila-rodona,259,33.11,Alt Camp,Interior,Valls,23,Tarragona,104,445,111,96,368,131,200,813,242,1255,660,595,0.5259,0.4741,0.1594,0.6478,0.1928,37.9
928,2019,Vila-sacra,16,6.03,Alt Empordà,Costal,Figueres,68,Girona,68,249,55,83,233,72,151,482,127,760,372,388,0.4895,0.5105,0.1987,0.6342,0.1671,126.04
929,2019,Vila-sana,249,19.1,Pla d'Urgell,Interior,Mollerussa,16,Lleida,70,253,53,52,233,81,122,486,134,742,376,366,0.5067,0.4933,0.1644,0.655,0.1806,38.85
930,2019,Vila-seca,45,21.64,Tarragonès,Costal,Tarragona,22,Tarragona,2144,7597,1372,2077,7389,1608,4221,14986,2980,22187,11113,11074,0.5009,0.4991,0.1902,0.6754,0.1343,1025.28
931,2019,Vilassar de Dalt,142,8.86,Maresme,Costal,Mataró,30,Barcelona,704,2989,769,694,2968,919,1398,5957,1688,9043,4462,4581,0.4934,0.5066,0.1546,0.6587,0.1867,1020.65
932,2019,Vilassar de Mar,10,4.0,Maresme,Costal,Mataró,30,Barcelona,1756,6578,1734,1627,6897,2245,3383,13475,3979,20837,10068,10769,0.4832,0.5168,0.1624,0.6467,0.191,5209.25
933,2019,Vilaür,65,5.49,Alt Empordà,Costal,Figueres,68,Girona,21,44,16,15,49,12,36,93,28,157,81,76,0.5159,0.4841,0.2293,0.5924,0.1783,28.6
934,2019,Vilaverd,269,12.61,Conca de Barberà,Interior,Montblanc,22,Tarragona,32,170,38,31,136,45,63,306,83,452,240,212,0.531,0.469,0.1394,0.677,0.1836,35.84
935,2019,"Vilella Alta, la",327,5.15,Priorat,Interior,Falset,23,Tarragona,8,47,18,11,33,18,19,80,36,135,73,62,0.5407,0.4593,0.1407,0.5926,0.2667,26.21
936,2019,"Vilella Baixa, la",218,5.62,Priorat,Interior,Falset,23,Tarragona,18,69,26,9,54,26,27,123,52,202,113,89,0.5594,0.4406,0.1337,0.6089,0.2574,35.94
937,2019,Vilobí d'Onyar,122,32.59,Selva,Costal,Sta. Coloma de Farners,26,Girona,297,1159,255,284,1008,288,581,2167,543,3291,1711,1580,0.5199,0.4801,0.1765,0.6585,0.165,100.98
938,2019,Vilobí del Penedès,286,9.34,Alt Penedès,Interior,Vilafranca del Penedès,27,Barcelona,101,361,107,90,329,119,191,690,226,1107,569,538,0.514,0.486,0.1725,0.6233,0.2042,118.52
939,2019,Vilopriu,82,16.38,Baix Empordà,Costal,"Bisbal d'Empordà, la",36,Girona,18,59,30,15,54,26,33,113,56,202,107,95,0.5297,0.4703,0.1634,0.5594,0.2772,12.33
940,2019,"Vilosell, el",665,18.88,Garrigues,Interior,"Borges Blanques, les",24,Lleida,4,52,32,4,46,31,8,98,63,169,88,81,0.5207,0.4793,0.0473,0.5799,0.3728,8.95
941,2019,Vimbodí i Poblet,496,66.09,Conca de Barberà,Interior,Montblanc,22,Tarragona,55,308,125,36,230,138,91,538,263,892,488,404,0.5471,0.4529,0.102,0.6031,0.2948,13.5
942,2019,Vinaixa,479,37.59,Garrigues,Interior,"Borges Blanques, les",24,Lleida,31,151,67,15,130,76,46,281,143,470,249,221,0.5298,0.4702,0.0979,0.5979,0.3043,12.5
943,2019,Vinebre,34,26.44,Ribera d'Ebre,Interior,Móra d'Ebre,14,Tarragona,41,137,43,25,125,57,66,262,100,428,221,207,0.5164,0.4836,0.1542,0.6121,0.2336,16.19
944,2019,Vinyols i els Arcs,95,10.83,Baix Camp,Costal,Reus,28,Tarragona,174,718,178,172,658,156,346,1376,334,2056,1070,986,0.5204,0.4796,0.1683,0.6693,0.1625,189.84
945,2019,Viver i Serrateix,729,66.8,Berguedà,Pre-Pirineu,Berga,31,Barcelona,10,54,23,13,42,26,23,96,49,168,87,81,0.5179,0.4821,0.1369,0.5714,0.2917,2.51
946,2019,Xerta,12,32.39,Baix Ebre,Costal,Tortosa,14,Tarragona,61,367,143,63,347,189,124,714,332,1170,571,599,0.488,0.512,0.106,0.6103,0.2838,36.12
947,2020,Abella de la Conca,956,78.27,Pallars Jussà,Pre-Pirineu,Tremp,14,Lleida,11,67,21,7,54,23,18,121,44,183,99,84,0.541,0.459,0.0984,0.6612,0.2404,2.34
948,2020,Abrera,105,19.94,Baix Llobregat,Costal,St. Feliu de Llobregat,30,Barcelona,1164,4274,887,1072,4091,1050,2236,8365,1937,12538,6325,6213,0.5045,0.4955,0.1783,0.6672,0.1545,628.79
949,2020,Àger,642,160.57,Noguera,Interior,Balaguer,30,Lleida,25,200,89,26,155,85,51,355,174,580,314,266,0.5414,0.4586,0.0879,0.6121,0.3,3.61
950,2020,Agramunt,337,79.65,Urgell,Interior,Tàrrega,20,Lleida,415,1807,488,422,1678,601,837,3485,1089,5411,2710,2701,0.5008,0.4992,0.1547,0.6441,0.2013,67.93
951,2020,Aguilar de Segarra,480,43.32,Bages,Interior,Manresa,30,Barcelona,26,94,28,28,83,23,54,177,51,282,148,134,0.5248,0.4752,0.1915,0.6277,0.1809,6.51
952,2020,Agullana,166,27.73,Alt Empordà,Costal,Figueres,68,Girona,67,275,89,68,270,94,135,545,183,863,431,432,0.4994,0.5006,0.1564,0.6315,0.2121,31.12
953,2020,Aiguafreda,404,7.9,Vallès Oriental,Interior,Granollers,39,Barcelona,157,830,234,165,795,331,322,1625,565,2512,1221,1291,0.4861,0.5139,0.1282,0.6469,0.2249,317.97
954,2020,Aiguamúrcia,314,72.95,Alt Camp,Interior,Valls,23,Tarragona,59,310,114,68,272,107,127,582,221,930,483,447,0.5194,0.4806,0.1366,0.6258,0.2376,12.75
955,2020,Aiguaviva,169,13.92,Gironès,Interior,Girona,27,Girona,75,254,56,64,257,59,139,511,115,765,385,380,0.5033,0.4967,0.1817,0.668,0.1503,54.96
956,2020,Aitona,110,66.9,Segrià,Costal,Lleida,38,Lleida,215,871,252,188,706,335,403,1577,587,2567,1338,1229,0.5212,0.4788,0.157,0.6143,0.2287,38.37
957,2020,"Alamús, els",212,20.53,Segrià,Costal,Lleida,38,Lleida,56,272,84,50,264,85,106,536,169,811,412,399,0.508,0.492,0.1307,0.6609,0.2084,39.5
958,2020,Alàs i Cerc,768,57.67,Alt Urgell,Pirineu,"Seu d'Urgell, la",19,Lleida,21,93,44,19,87,56,40,180,100,320,158,162,0.4938,0.5062,0.125,0.5625,0.3125,5.55
959,2020,"Albagés, l'",372,25.7,Garrigues,Interior,"Borges Blanques, les",24,Lleida,13,122,54,14,102,56,27,224,110,361,189,172,0.5235,0.4765,0.0748,0.6205,0.3047,14.05
960,2020,Albanyà,239,94.39,Alt Empordà,Costal,Figueres,68,Girona,18,47,14,19,46,11,37,93,25,155,79,76,0.5097,0.4903,0.2387,0.6,0.1613,1.64
961,2020,Albatàrrec,147,10.46,Segrià,Costal,Lleida,38,Lleida,184,839,119,183,756,155,367,1595,274,2236,1142,1094,0.5107,0.4893,0.1641,0.7133,0.1225,213.77
962,2020,Albesa,237,37.61,Noguera,Interior,Balaguer,30,Lleida,117,565,166,95,418,200,212,983,366,1561,848,713,0.5432,0.4568,0.1358,0.6297,0.2345,41.5
963,2020,"Albi, l'",526,32.54,Garrigues,Interior,"Borges Blanques, les",24,Lleida,59,215,104,42,200,124,101,415,228,744,378,366,0.5081,0.4919,0.1358,0.5578,0.3065,22.86
964,2020,Albinyana,198,19.37,Baix Penedès,Costal,"Vendrell, el",14,Tarragona,193,865,215,163,765,267,356,1630,482,2468,1273,1195,0.5158,0.4842,0.1442,0.6605,0.1953,127.41
965,2020,"Albiol, l'",823,20.34,Baix Camp,Costal,Reus,28,Tarragona,66,167,39,40,157,31,106,324,70,500,272,228,0.544,0.456,0.212,0.648,0.14,24.58
966,2020,Albons,25,11.13,Baix Empordà,Costal,"Bisbal d'Empordà, la",36,Girona,53,262,76,54,242,72,107,504,148,759,391,368,0.5152,0.4848,0.141,0.664,0.195,68.19
967,2020,Alcanar,72,47.07,Montsià,Costal,Amposta,12,Tarragona,665,3176,941,642,2933,1077,1307,6109,2018,9434,4782,4652,0.5069,0.4931,0.1385,0.6476,0.2139,200.42
968,2020,Alcanó,214,21.03,Segrià,Costal,Lleida,38,Lleida,18,74,29,14,68,35,32,142,64,238,121,117,0.5084,0.4916,0.1345,0.5966,0.2689,11.32
969,2020,Alcarràs,137,114.29,Segrià,Costal,Lleida,38,Lleida,952,3612,532,854,3113,644,1806,6725,1176,9707,5096,4611,0.525,0.475,0.1861,0.6928,0.1211,84.93
970,2020,Alcoletge,213,16.7,Segrià,Costal,Lleida,38,Lleida,301,1286,218,299,1095,236,600,2381,454,3435,1805,1630,0.5255,0.4745,0.1747,0.6932,0.1322,205.69
971,2020,Alcover,243,46.0,Alt Camp,Interior,Valls,23,Tarragona,424,1715,416,441,1644,504,865,3359,920,5144,2555,2589,0.4967,0.5033,0.1682,0.653,0.1788,111.83
972,2020,"Aldea, l'",9,35.21,Baix Ebre,Costal,Tortosa,14,Tarragona,330,1433,434,269,1213,468,599,2646,902,4147,2197,1950,0.5298,0.4702,0.1444,0.6381,0.2175,117.78
973,2020,Aldover,14,20.2,Baix Ebre,Costal,Tortosa,14,Tarragona,57,286,114,44,262,142,101,548,256,905,457,448,0.505,0.495,0.1116,0.6055,0.2829,44.8
974,2020,"Aleixar, l'",262,26.1,Baix Camp,Costal,Reus,28,Tarragona,66,319,73,66,289,80,132,608,153,893,458,435,0.5129,0.4871,0.1478,0.6809,0.1713,34.21
975,2020,Alella,90,9.58,Maresme,Costal,Mataró,30,Barcelona,850,3005,983,738,3222,1106,1588,6227,2089,9904,4838,5066,0.4885,0.5115,0.1603,0.6287,0.2109,1033.82
976,2020,Alfara de Carles,334,63.87,Baix Ebre,Costal,Tortosa,14,Tarragona,15,130,56,18,98,59,33,228,115,376,201,175,0.5346,0.4654,0.0878,0.6064,0.3059,5.89
977,2020,Alfarràs,281,11.4,Segrià,Costal,Lleida,38,Lleida,176,956,308,181,785,359,357,1741,667,2765,1440,1325,0.5208,0.4792,0.1291,0.6297,0.2412,242.54
978,2020,Alfés,236,31.94,Segrià,Costal,Lleida,38,Lleida,21,100,38,15,81,42,36,181,80,297,159,138,0.5354,0.4646,0.1212,0.6094,0.2694,9.3
979,2020,Alforja,374,38.24,Baix Camp,Costal,Reus,28,Tarragona,122,639,158,115,558,191,237,1197,349,1783,919,864,0.5154,0.4846,0.1329,0.6713,0.1957,46.63
980,2020,Algerri,345,54.32,Noguera,Interior,Balaguer,30,Lleida,23,129,67,15,88,82,38,217,149,404,219,185,0.5421,0.4579,0.0941,0.5371,0.3688,7.44
981,2020,Alguaire,304,50.11,Segrià,Costal,Lleida,38,Lleida,198,1110,298,233,850,340,431,1960,638,3029,1606,1423,0.5302,0.4698,0.1423,0.6471,0.2106,60.45
982,2020,Alins,1048,183.19,Pallars Sobirà,Pirineu,Sort,15,Lleida,13,88,42,11,79,39,24,167,81,272,143,129,0.5257,0.4743,0.0882,0.614,0.2978,1.48
983,2020,Alió,263,7.25,Alt Camp,Interior,Valls,23,Tarragona,34,128,57,46,148,45,80,276,102,458,219,239,0.4782,0.5218,0.1747,0.6026,0.2227,63.17
984,2020,Almacelles,247,49.03,Segrià,Costal,Lleida,38,Lleida,513,2530,606,454,1991,732,967,4521,1338,6826,3649,3177,0.5346,0.4654,0.1417,0.6623,0.196,139.22
985,2020,Almatret,462,56.83,Segrià,Costal,Lleida,38,Lleida,7,108,55,5,70,60,12,178,115,305,170,135,0.5574,0.4426,0.0393,0.5836,0.377,5.37
986,2020,Almenar,329,66.59,Segrià,Costal,Lleida,38,Lleida,225,1189,360,200,949,434,425,2138,794,3357,1774,1583,0.5284,0.4716,0.1266,0.6369,0.2365,50.41
987,2020,Almoster,290,5.96,Baix Camp,Costal,Reus,28,Tarragona,91,484,99,89,477,101,180,961,200,1341,674,667,0.5026,0.4974,0.1342,0.7166,0.1491,225.0
988,2020,Alòs de Balaguer,297,69.08,Noguera,Interior,Balaguer,30,Lleida,5,49,25,3,27,23,8,76,48,132,79,53,0.5985,0.4015,0.0606,0.5758,0.3636,1.91
989,2020,Alp,1158,44.29,Cerdanya,Pirineu,Puigcerdà,17,Girona,98,614,111,85,558,127,183,1172,238,1593,823,770,0.5166,0.4834,0.1149,0.7357,0.1494,35.97
990,2020,Alpens,855,13.8,Osona,Interior,Vic,50,Barcelona,19,99,19,12,84,28,31,183,47,261,137,124,0.5249,0.4751,0.1188,0.7011,0.1801,18.91
991,2020,Alpicat,264,15.33,Segrià,Costal,Lleida,38,Lleida,572,2145,421,569,2075,484,1141,4220,905,6266,3138,3128,0.5008,0.4992,0.1821,0.6735,0.1444,408.74
992,2020,Alt Àneu,1076,217.76,Pallars Sobirà,Pirineu,Sort,15,Lleida,25,159,55,12,124,39,37,283,94,414,239,175,0.5773,0.4227,0.0894,0.6836,0.2271,1.9
993,2020,Altafulla,52,6.95,Tarragonès,Costal,Tarragona,22,Tarragona,450,1676,453,467,1737,524,917,3413,977,5307,2579,2728,0.486,0.514,0.1728,0.6431,0.1841,763.6
994,2020,Amer,186,40.08,Selva,Costal,Sta. Coloma de Farners,26,Girona,156,737,251,155,716,317,311,1453,568,2332,1144,1188,0.4906,0.5094,0.1334,0.6231,0.2436,58.18
995,2020,"Ametlla de Mar, l'",19,66.86,Baix Ebre,Costal,Tortosa,14,Tarragona,485,2206,801,440,2066,868,925,4272,1669,6866,3492,3374,0.5086,0.4914,0.1347,0.6222,0.2431,102.69
996,2020,"Ametlla del Vallès, l'",281,14.24,Vallès Oriental,Interior,Granollers,39,Barcelona,717,3018,623,663,2946,679,1380,5964,1302,8646,4358,4288,0.504,0.496,0.1596,0.6898,0.1506,607.16
997,2020,"Ampolla, l'",8,35.65,Baix Ebre,Costal,Tortosa,14,Tarragona,186,1065,432,197,959,438,383,2024,870,3277,1683,1594,0.5136,0.4864,0.1169,0.6176,0.2655,91.92
998,2020,Amposta,8,138.31,Montsià,Costal,Amposta,12,Tarragona,1833,7026,1816,1602,6671,2167,3435,13697,3983,21115,10675,10440,0.5056,0.4944,0.1627,0.6487,0.1886,152.66
999,2020,Anglès,181,16.31,Selva,Costal,Sta. Coloma de Farners,26,Girona,486,1867,464,467,1773,597,953,3640,1061,5654,2817,2837,0.4982,0.5018,0.1686,0.6438,0.1877,346.66
1000,2020,Anglesola,335,23.53,Urgell,Interior,Tàrrega,20,Lleida,102,443,144,122,376,178,224,819,322,1365,689,676,0.5048,0.4952,0.1641,0.6,0.2359,58.01
1001,2020,Arbeca,332,58.34,Garrigues,Interior,"Borges Blanques, les",24,Lleida,116,715,270,114,615,296,230,1330,566,2126,1101,1025,0.5179,0.4821,0.1082,0.6256,0.2662,36.44
1002,2020,"Arboç, l'",166,14.13,Baix Penedès,Costal,"Vendrell, el",14,Tarragona,522,1943,416,509,1727,492,1031,3670,908,5609,2881,2728,0.5136,0.4864,0.1838,0.6543,0.1619,396.96
1003,2020,Arbolí,714,20.78,Baix Camp,Costal,Reus,28,Tarragona,5,56,13,5,34,14,10,90,27,127,74,53,0.5827,0.4173,0.0787,0.7087,0.2126,6.11
1004,2020,Arbúcies,291,86.22,Selva,Costal,Sta. Coloma de Farners,26,Girona,548,2313,555,532,2004,656,1080,4317,1211,6608,3416,3192,0.5169,0.4831,0.1634,0.6533,0.1833,76.64
1005,2020,Arenys de Mar,10,6.75,Maresme,Costal,Mataró,30,Barcelona,1183,5167,1411,1070,5058,2052,2253,10225,3463,15941,7761,8180,0.4869,0.5131,0.1413,0.6414,0.2172,2361.63
1006,2020,Arenys de Munt,121,21.29,Maresme,Costal,Mataró,30,Barcelona,776,3081,734,658,2999,873,1434,6080,1607,9121,4591,4530,0.5033,0.4967,0.1572,0.6666,0.1762,428.42
1007,2020,Argelaguer,183,12.54,Garrotxa,Pre-Pirineu,Olot,21,Girona,23,140,44,18,127,44,41,267,88,396,207,189,0.5227,0.4773,0.1035,0.6742,0.2222,31.58
1008,2020,Argençola,716,47.09,Anoia,Interior,Igualada,33,Barcelona,12,82,19,18,67,21,30,149,40,219,113,106,0.516,0.484,0.137,0.6804,0.1826,4.65
1009,2020,"Argentera, l'",344,10.12,Baix Camp,Costal,Reus,28,Tarragona,0,50,16,3,30,18,3,80,34,117,66,51,0.5641,0.4359,0.0256,0.6838,0.2906,11.56
1010,2020,Argentona,88,25.4,Maresme,Costal,Mataró,30,Barcelona,1030,4170,997,957,4117,1265,1987,8287,2262,12536,6197,6339,0.4943,0.5057,0.1585,0.6611,0.1804,493.54
1011,2020,"Armentera, l'",7,5.6,Alt Empordà,Costal,Figueres,68,Girona,85,300,93,87,282,104,172,582,197,951,478,473,0.5026,0.4974,0.1809,0.612,0.2072,169.82
1012,2020,Arnes,506,42.97,Terra Alta,Interior,Gandesa,12,Tarragona,19,115,85,21,113,91,40,228,176,444,219,225,0.4932,0.5068,0.0901,0.5135,0.3964,10.33
1013,2020,Arres,1224,11.57,Val d'Aran,Pirineu,Vielha,9,Lleida,1,32,6,3,16,2,4,48,8,60,39,21,0.65,0.35,0.0667,0.8,0.1333,5.19
1014,2020,Arsèguel,950,10.59,Alt Urgell,Pirineu,"Seu d'Urgell, la",19,Lleida,8,28,10,6,24,5,14,52,15,81,46,35,0.5679,0.4321,0.1728,0.642,0.1852,7.65
1015,2020,Artés,316,17.87,Bages,Interior,Manresa,30,Barcelona,465,1975,471,451,1810,590,916,3785,1061,5762,2911,2851,0.5052,0.4948,0.159,0.6569,0.1841,322.44
1016,2020,Artesa de Lleida,202,23.94,Segrià,Costal,Lleida,38,Lleida,100,583,133,90,463,166,190,1046,299,1535,816,719,0.5316,0.4684,0.1238,0.6814,0.1948,64.12
1017,2020,Artesa de Segre,318,175.9,Noguera,Interior,Balaguer,30,Lleida,237,1169,350,225,1024,395,462,2193,745,3400,1756,1644,0.5165,0.4835,0.1359,0.645,0.2191,19.33
1018,2020,Ascó,70,73.63,Ribera d'Ebre,Interior,Móra d'Ebre,14,Tarragona,102,542,200,94,495,211,196,1037,411,1644,844,800,0.5134,0.4866,0.1192,0.6308,0.25,22.33
1019,2020,Aspa,256,10.21,Segrià,Costal,Lleida,38,Lleida,10,70,35,10,57,38,20,127,73,220,115,105,0.5227,0.4773,0.0909,0.5773,0.3318,21.55
1020,2020,"Avellanes i Santa Linya, les",567,102.96,Noguera,Interior,Balaguer,30,Lleida,22,144,83,25,91,68,47,235,151,433,249,184,0.5751,0.4249,0.1085,0.5427,0.3487,4.21
1021,2020,Avià,677,27.23,Berguedà,Pre-Pirineu,Berga,31,Barcelona,180,718,215,154,707,246,334,1425,461,2220,1113,1107,0.5014,0.4986,0.1505,0.6419,0.2077,81.53
1022,2020,Avinyó,353,63.23,Bages,Interior,Manresa,30,Barcelona,171,763,203,163,693,296,334,1456,499,2289,1137,1152,0.4967,0.5033,0.1459,0.6361,0.218,36.2
1023,2020,Avinyonet de Puigventós,70,12.3,Alt Empordà,Costal,Figueres,68,Girona,147,579,92,147,582,94,294,1161,186,1641,818,823,0.4985,0.5015,0.1792,0.7075,0.1133,133.41
1024,2020,Avinyonet del Penedès,280,29.13,Alt Penedès,Interior,Vilafranca del Penedès,27,Barcelona,110,628,161,114,507,177,224,1135,338,1697,899,798,0.5298,0.4702,0.132,0.6688,0.1992,58.26
1025,2020,Badalona,6,21.18,Barcelonès,Costal,Barcelona,5,Barcelona,17590,74108,18320,16506,72614,24028,34096,146722,42348,223166,110018,113148,0.493,0.507,0.1528,0.6575,0.1898,10536.64
1026,2020,Badia del Vallès,120,0.93,Vallès Occidental,Interior,Sabadell i Terrassa,23,Barcelona,1029,4369,1170,977,4204,1666,2006,8573,2836,13415,6568,6847,0.4896,0.5104,0.1495,0.6391,0.2114,14424.73
1027,2020,Bagà,785,43.13,Berguedà,Pre-Pirineu,Berga,31,Barcelona,116,680,265,113,641,325,229,1321,590,2140,1061,1079,0.4958,0.5042,0.107,0.6173,0.2757,49.62
1028,2020,Baix Pallars,591,129.41,Pallars Sobirà,Pirineu,Sort,15,Lleida,20,122,38,18,92,41,38,214,79,331,180,151,0.5438,0.4562,0.1148,0.6465,0.2387,2.56
1029,2020,Balaguer,233,57.32,Noguera,Interior,Balaguer,30,Lleida,1550,6117,1286,1434,5320,1765,2984,11437,3051,17472,8953,8519,0.5124,0.4876,0.1708,0.6546,0.1746,304.82
1030,2020,Balenyà,587,17.37,Osona,Interior,Vic,50,Barcelona,316,1321,284,289,1262,368,605,2583,652,3840,1921,1919,0.5003,0.4997,0.1576,0.6727,0.1698,221.07
1031,2020,Balsareny,327,36.91,Bages,Interior,Manresa,30,Barcelona,188,1092,296,203,977,436,391,2069,732,3192,1576,1616,0.4937,0.5063,0.1225,0.6482,0.2293,86.48
1032,2020,Banyeres del Penedès,173,12.19,Baix Penedès,Costal,"Vendrell, el",14,Tarragona,278,1081,266,275,1033,274,553,2114,540,3207,1625,1582,0.5067,0.4933,0.1724,0.6592,0.1684,263.08
1033,2020,Banyoles,172,11.05,Pla de l'Estany,Interior,Banyoles,11,Girona,1825,6681,1480,1693,6392,1982,3518,13073,3462,20053,9986,10067,0.498,0.502,0.1754,0.6519,0.1726,1814.75
1034,2020,Barbens,283,7.56,Pla d'Urgell,Interior,Mollerussa,16,Lleida,53,318,97,55,239,116,108,557,213,878,468,410,0.533,0.467,0.123,0.6344,0.2426,116.14
1035,2020,Barberà de la Conca,475,26.6,Conca de Barberà,Interior,Montblanc,22,Tarragona,34,171,55,31,116,64,65,287,119,471,260,211,0.552,0.448,0.138,0.6093,0.2527,17.71
1036,2020,Barberà del Vallès,146,8.31,Vallès Occidental,Interior,Sabadell i Terrassa,23,Barcelona,2788,11069,2538,2753,10974,3212,5541,22043,5750,33334,16395,16939,0.4918,0.5082,0.1662,0.6613,0.1725,4011.31
1037,2020,Barcelona,9,101.35,Barcelonès,Costal,Barcelona,5,Barcelona,104905,544980,140823,99367,562944,211163,204272,1107924,351986,1664182,790708,873474,0.4751,0.5249,0.1227,0.6657,0.2115,16420.15
1038,2020,"Baronia de Rialb, la",388,145.08,Noguera,Interior,Balaguer,30,Lleida,5,74,37,11,66,36,16,140,73,229,116,113,0.5066,0.4934,0.0699,0.6114,0.3188,1.58
1039,2020,Bàscara,66,17.5,Alt Empordà,Costal,Figueres,68,Girona,79,349,93,70,285,125,149,634,218,1001,521,480,0.5205,0.4795,0.1489,0.6334,0.2178,57.2
1040,2020,Bassella,423,70.25,Alt Urgell,Pirineu,"Seu d'Urgell, la",19,Lleida,13,68,31,6,69,30,19,137,61,217,112,105,0.5161,0.4839,0.0876,0.6313,0.2811,3.09
1041,2020,Batea,376,128.41,Terra Alta,Interior,Gandesa,12,Tarragona,138,546,265,127,517,308,265,1063,573,1901,949,952,0.4992,0.5008,0.1394,0.5592,0.3014,14.8
1042,2020,Bausen,931,17.72,Val d'Aran,Pirineu,Vielha,9,Lleida,0,16,14,2,15,13,2,31,27,60,30,30,0.5,0.5,0.0333,0.5167,0.45,3.39
1043,2020,Begues,399,50.44,Baix Llobregat,Costal,St. Feliu de Llobregat,30,Barcelona,685,2489,476,668,2453,529,1353,4942,1005,7300,3650,3650,0.5,0.5,0.1853,0.677,0.1377,144.73
1044,2020,Begur,200,20.66,Baix Empordà,Costal,"Bisbal d'Empordà, la",36,Girona,234,1321,400,238,1259,439,472,2580,839,3891,1955,1936,0.5024,0.4976,0.1213,0.6631,0.2156,188.33
1045,2020,Belianes,373,15.69,Urgell,Interior,Tàrrega,20,Lleida,25,151,85,25,151,83,50,302,168,520,261,259,0.5019,0.4981,0.0962,0.5808,0.3231,33.14
1046,2020,Bellaguarda,640,17.14,Garrigues,Interior,"Borges Blanques, les",24,Lleida,12,97,41,8,79,50,20,176,91,287,150,137,0.5226,0.4774,0.0697,0.6132,0.3171,16.74
1047,2020,Bellcaire d'Empordà,35,12.64,Baix Empordà,Costal,"Bisbal d'Empordà, la",36,Girona,45,215,65,53,216,84,98,431,149,678,325,353,0.4794,0.5206,0.1445,0.6357,0.2198,53.64
1048,2020,Bellcaire d'Urgell,267,31.38,Noguera,Interior,Balaguer,30,Lleida,71,397,139,76,336,180,147,733,319,1199,607,592,0.5063,0.4937,0.1226,0.6113,0.2661,38.21
1049,2020,Bell-lloc d'Urgell,196,34.92,Pla d'Urgell,Interior,Mollerussa,16,Lleida,154,793,212,173,731,272,327,1524,484,2335,1159,1176,0.4964,0.5036,0.14,0.6527,0.2073,66.87
1050,2020,Bellmunt d'Urgell,379,5.11,Noguera,Interior,Balaguer,30,Lleida,10,60,20,12,53,30,22,113,50,185,90,95,0.4865,0.5135,0.1189,0.6108,0.2703,36.2
1051,2020,Bellmunt del Priorat,261,8.86,Priorat,Interior,Falset,23,Tarragona,20,90,32,7,81,43,27,171,75,273,142,131,0.5201,0.4799,0.0989,0.6264,0.2747,30.81
1052,2020,Bellprat,653,30.97,Anoia,Interior,Igualada,33,Barcelona,0,25,16,1,13,9,1,38,25,64,41,23,0.6406,0.3594,0.0156,0.5938,0.3906,2.07
1053,2020,Bellpuig,308,34.98,Urgell,Interior,Tàrrega,20,Lleida,373,1989,412,420,1495,529,793,3484,941,5218,2774,2444,0.5316,0.4684,0.152,0.6677,0.1803,149.17
1054,2020,Bellvei,108,8.27,Baix Penedès,Costal,"Vendrell, el",14,Tarragona,206,769,187,190,690,195,396,1459,382,2237,1162,1075,0.5194,0.4806,0.177,0.6522,0.1708,270.5
1055,2020,Bellver de Cerdanya,1061,98.15,Cerdanya,Pirineu,Puigcerdà,17,Girona,149,676,210,133,607,230,282,1283,440,2005,1035,970,0.5162,0.4838,0.1406,0.6399,0.2195,20.43
1056,2020,Bellvís,207,46.7,Pla d'Urgell,Interior,Mollerussa,16,Lleida,168,755,236,132,638,331,300,1393,567,2260,1159,1101,0.5128,0.4872,0.1327,0.6164,0.2509,48.39
1057,2020,Benavent de Segrià,234,7.43,Segrià,Costal,Lleida,38,Lleida,115,581,110,104,483,125,219,1064,235,1518,806,712,0.531,0.469,0.1443,0.7009,0.1548,204.31
1058,2020,Benifallet,19,62.42,Baix Ebre,Costal,Tortosa,14,Tarragona,25,212,99,32,221,134,57,433,233,723,336,387,0.4647,0.5353,0.0788,0.5989,0.3223,11.58
1059,2020,Benissanet,26,23.06,Ribera d'Ebre,Interior,Móra d'Ebre,14,Tarragona,68,432,130,65,298,147,133,730,277,1140,630,510,0.5526,0.4474,0.1167,0.6404,0.243,49.44
1060,2020,Berga,704,22.57,Berguedà,Pre-Pirineu,Berga,31,Barcelona,1260,5475,1580,1089,5209,2147,2349,10684,3727,16760,8315,8445,0.4961,0.5039,0.1402,0.6375,0.2224,742.58
1061,2020,Besalú,151,4.93,Garrotxa,Pre-Pirineu,Olot,21,Girona,204,723,254,200,781,325,404,1504,579,2487,1181,1306,0.4749,0.5251,0.1624,0.6047,0.2328,504.46
1062,2020,Bescanó,102,35.92,Gironès,Interior,Girona,27,Girona,502,1660,360,444,1591,434,946,3251,794,4991,2522,2469,0.5053,0.4947,0.1895,0.6514,0.1591,138.95
1063,2020,Beuda,338,35.91,Garrotxa,Pre-Pirineu,Olot,21,Girona,14,74,11,20,56,11,34,130,22,186,99,87,0.5323,0.4677,0.1828,0.6989,0.1183,5.18
1064,2020,Bigues i Riells del Fai,307,28.64,Vallès Oriental,Interior,Granollers,39,Barcelona,782,3321,676,758,3079,742,1540,6400,1418,9358,4779,4579,0.5107,0.4893,0.1646,0.6839,0.1515,326.75
1065,2020,Biosca,455,66.21,Segarra,Interior,Cervera,21,Lleida,4,59,31,6,44,33,10,103,64,177,94,83,0.5311,0.4689,0.0565,0.5819,0.3616,2.67
1066,2020,"Bisbal d'Empordà, la",39,20.62,Baix Empordà,Costal,"Bisbal d'Empordà, la",36,Girona,1038,3722,805,958,3576,1060,1996,7298,1865,11159,5565,5594,0.4987,0.5013,0.1789,0.654,0.1671,541.17
1067,2020,"Bisbal de Falset, la",372,14.14,Priorat,Interior,Falset,23,Tarragona,17,69,30,9,50,36,26,119,66,211,116,95,0.5498,0.4502,0.1232,0.564,0.3128,14.92
1068,2020,"Bisbal del Penedès, la",189,32.54,Baix Penedès,Costal,"Vendrell, el",14,Tarragona,252,1281,385,238,1108,367,490,2389,752,3631,1918,1713,0.5282,0.4718,0.1349,0.6579,0.2071,111.59
1069,2020,Biure,81,10.02,Alt Empordà,Costal,Figueres,68,Girona,13,74,38,10,72,34,23,146,72,241,125,116,0.5187,0.4813,0.0954,0.6058,0.2988,24.05
1070,2020,Blancafort,428,14.48,Conca de Barberà,Interior,Montblanc,22,Tarragona,19,134,47,21,107,54,40,241,101,382,200,182,0.5236,0.4764,0.1047,0.6309,0.2644,26.38
1071,2020,Blanes,13,17.66,Selva,Costal,Sta. Coloma de Farners,26,Girona,2847,13629,3370,2710,13126,4232,5557,26755,7602,39914,19846,20068,0.4972,0.5028,0.1392,0.6703,0.1905,2260.14
1072,2020,Boadella i les Escaules,82,10.78,Alt Empordà,Costal,Figueres,68,Girona,13,93,31,18,88,29,31,181,60,272,137,135,0.5037,0.4963,0.114,0.6654,0.2206,25.23
1073,2020,Bolvir,1145,10.34,Cerdanya,Pirineu,Puigcerdà,17,Girona,27,134,36,17,121,40,44,255,76,375,197,178,0.5253,0.4747,0.1173,0.68,0.2027,36.27
1074,2020,Bonastre,177,24.97,Baix Penedès,Costal,"Vendrell, el",14,Tarragona,56,243,60,59,213,54,115,456,114,685,359,326,0.5241,0.4759,0.1679,0.6657,0.1664,27.43
1075,2020,"Bòrdes, Es",852,21.44,Val d'Aran,Pirineu,Vielha,9,Lleida,17,100,25,17,75,21,34,175,46,255,142,113,0.5569,0.4431,0.1333,0.6863,0.1804,11.89
1076,2020,Bordils,42,7.32,Gironès,Interior,Girona,27,Girona,146,599,140,137,576,163,283,1175,303,1761,885,876,0.5026,0.4974,0.1607,0.6672,0.1721,240.57
1077,2020,"Borges Blanques, les",304,61.55,Garrigues,Interior,"Borges Blanques, les",24,Lleida,502,2048,602,457,1829,735,959,3877,1337,6173,3152,3021,0.5106,0.4894,0.1554,0.6281,0.2166,100.29
1078,2020,"Borges del Camp, les",238,8.24,Baix Camp,Costal,Reus,28,Tarragona,189,694,170,156,620,227,345,1314,397,2056,1053,1003,0.5122,0.4878,0.1678,0.6391,0.1931,249.51
1079,2020,Borrassà,73,9.45,Alt Empordà,Costal,Figueres,68,Girona,74,243,63,64,217,72,138,460,135,733,380,353,0.5184,0.4816,0.1883,0.6276,0.1842,77.57
1080,2020,Borredà,854,43.45,Berguedà,Pre-Pirineu,Berga,31,Barcelona,20,177,60,20,123,64,40,300,124,464,257,207,0.5539,0.4461,0.0862,0.6466,0.2672,10.68
1081,2020,Bossòst,710,28.17,Val d'Aran,Pirineu,Vielha,9,Lleida,67,388,89,78,376,117,145,764,206,1115,544,571,0.4879,0.5121,0.13,0.6852,0.1848,39.58
1082,2020,Bot,286,34.94,Terra Alta,Interior,Gandesa,12,Tarragona,26,162,96,20,144,106,46,306,202,554,284,270,0.5126,0.4874,0.083,0.5523,0.3646,15.86
1083,2020,Botarell,196,11.95,Baix Camp,Costal,Reus,28,Tarragona,90,396,66,94,351,80,184,747,146,1077,552,525,0.5125,0.4875,0.1708,0.6936,0.1356,90.13
1084,2020,Bovera,297,31.12,Garrigues,Interior,"Borges Blanques, les",24,Lleida,10,81,47,10,52,48,20,133,95,248,138,110,0.5565,0.4435,0.0806,0.5363,0.3831,7.97
1085,2020,Bràfim,236,6.42,Alt Camp,Interior,Valls,23,Tarragona,67,220,68,56,192,92,123,412,160,695,355,340,0.5108,0.4892,0.177,0.5928,0.2302,108.26
1086,2020,Breda,169,5.02,Selva,Costal,Sta. Coloma de Farners,26,Girona,232,1248,362,273,1192,455,505,2440,817,3762,1842,1920,0.4896,0.5104,0.1342,0.6486,0.2172,749.4
1087,2020,"Bruc, el",489,47.2,Anoia,Interior,Igualada,33,Barcelona,197,788,143,180,666,136,377,1454,279,2110,1128,982,0.5346,0.4654,0.1787,0.6891,0.1322,44.7
1088,2020,"Brull, el",843,41.03,Osona,Interior,Vic,50,Barcelona,27,95,20,24,72,20,51,167,40,258,142,116,0.5504,0.4496,0.1977,0.6473,0.155,6.29
1089,2020,Brunyola i Sant Martí Sapresa,247,36.82,Selva,Costal,Sta. Coloma de Farners,26,Girona,24,130,49,23,117,46,47,247,95,389,203,186,0.5219,0.4781,0.1208,0.635,0.2442,10.56
1090,2020,Cabacés,358,31.27,Priorat,Interior,Falset,23,Tarragona,19,102,41,22,75,43,41,177,84,302,162,140,0.5364,0.4636,0.1358,0.5861,0.2781,9.66
1091,2020,Cabanabona,421,14.16,Noguera,Interior,Balaguer,30,Lleida,1,26,7,1,20,16,2,46,23,71,34,37,0.4789,0.5211,0.0282,0.6479,0.3239,5.01
1092,2020,Cabanelles,194,55.58,Alt Empordà,Costal,Figueres,68,Girona,26,96,28,17,67,33,43,163,61,267,150,117,0.5618,0.4382,0.161,0.6105,0.2285,4.8
1093,2020,Cabanes,26,15.02,Alt Empordà,Costal,Figueres,68,Girona,67,341,112,69,277,102,136,618,214,968,520,448,0.5372,0.4628,0.1405,0.6384,0.2211,64.45
1094,2020,"Cabanyes, les",252,1.15,Alt Penedès,Interior,Vilafranca del Penedès,27,Barcelona,105,322,72,77,336,67,182,658,139,979,499,480,0.5097,0.4903,0.1859,0.6721,0.142,851.3
1095,2020,Cabó,768,80.33,Alt Urgell,Pirineu,"Seu d'Urgell, la",19,Lleida,3,33,14,5,23,15,8,56,29,93,50,43,0.5376,0.4624,0.086,0.6022,0.3118,1.16
1096,2020,Cabra del Camp,493,26.95,Alt Camp,Interior,Valls,23,Tarragona,77,418,118,75,374,113,152,792,231,1175,613,562,0.5217,0.4783,0.1294,0.674,0.1966,43.6
1097,2020,Cabrera d'Anoia,299,17.0,Anoia,Interior,Igualada,33,Barcelona,115,576,104,104,475,108,219,1051,212,1482,795,687,0.5364,0.4636,0.1478,0.7092,0.143,87.18
1098,2020,Cabrera de Mar,104,8.98,Maresme,Costal,Mataró,30,Barcelona,366,1601,414,345,1600,421,711,3201,835,4747,2381,2366,0.5016,0.4984,0.1498,0.6743,0.1759,528.62
1099,2020,Cabrils,147,7.05,Maresme,Costal,Mataró,30,Barcelona,611,2510,546,598,2600,567,1209,5110,1113,7432,3667,3765,0.4934,0.5066,0.1627,0.6876,0.1498,1054.18
1100,2020,Cadaqués,23,26.43,Alt Empordà,Costal,Figueres,68,Girona,169,911,220,177,948,270,346,1859,490,2695,1300,1395,0.4824,0.5176,0.1284,0.6898,0.1818,101.97
1101,2020,Calaf,680,9.22,Anoia,Interior,Igualada,33,Barcelona,342,1157,344,315,1080,418,657,2237,762,3656,1843,1813,0.5041,0.4959,0.1797,0.6119,0.2084,396.53
1102,2020,Calafell,67,20.38,Baix Penedès,Costal,"Vendrell, el",14,Tarragona,2120,9212,2555,1925,8852,2937,4045,18064,5492,27601,13887,13714,0.5031,0.4969,0.1466,0.6545,0.199,1354.32
1103,2020,Calders,552,33.09,Moianès,Interior,Moià,10,Barcelona,82,362,86,76,345,94,158,707,180,1045,530,515,0.5072,0.4928,0.1512,0.6766,0.1722,31.58
1104,2020,Caldes d'Estrac,33,0.88,Maresme,Costal,Mataró,30,Barcelona,205,984,253,197,1014,368,402,1998,621,3021,1442,1579,0.4773,0.5227,0.1331,0.6614,0.2056,3432.95
1105,2020,Caldes de Malavella,84,57.33,Selva,Costal,Sta. Coloma de Farners,26,Girona,682,2653,600,644,2584,709,1326,5237,1309,7872,3935,3937,0.4999,0.5001,0.1684,0.6653,0.1663,137.31
1106,2020,Caldes de Montbui,203,37.45,Vallès Oriental,Interior,Granollers,39,Barcelona,1452,5998,1423,1300,5786,1853,2752,11784,3276,17812,8873,8939,0.4981,0.5019,0.1545,0.6616,0.1839,475.62
1107,2020,Calella,5,8.0,Maresme,Costal,Mataró,30,Barcelona,1380,6371,1648,1333,6183,2362,2713,12554,4010,19277,9399,9878,0.4876,0.5124,0.1407,0.6512,0.208,2409.62
1108,2020,Calldetenes,489,5.8,Osona,Interior,Vic,50,Barcelona,199,864,218,198,798,236,397,1662,454,2513,1281,1232,0.5097,0.4903,0.158,0.6614,0.1807,433.28
1109,2020,Callús,260,12.5,Bages,Interior,Manresa,30,Barcelona,181,725,147,187,665,224,368,1390,371,2129,1053,1076,0.4946,0.5054,0.1729,0.6529,0.1743,170.32
1110,2020,Calonge de Segarra,688,37.15,Anoia,Interior,Igualada,33,Barcelona,9,64,19,10,51,35,19,115,54,188,92,96,0.4894,0.5106,0.1011,0.6117,0.2872,5.06
1111,2020,Calonge i Sant Antoni,22,33.57,Baix Empordà,Costal,"Bisbal d'Empordà, la",36,Girona,875,3746,1060,749,3700,1201,1624,7446,2261,11331,5681,5650,0.5014,0.4986,0.1433,0.6571,0.1995,337.53
1112,2020,Camarasa,321,157.13,Noguera,Interior,Balaguer,30,Lleida,47,243,116,41,224,139,88,467,255,810,406,404,0.5012,0.4988,0.1086,0.5765,0.3148,5.15
1113,2020,Camarles,13,25.16,Baix Ebre,Costal,Tortosa,14,Tarragona,251,1020,346,179,962,436,430,1982,782,3194,1617,1577,0.5063,0.4937,0.1346,0.6205,0.2448,126.95
1114,2020,Cambrils,24,35.21,Baix Camp,Costal,Reus,28,Tarragona,3080,11347,2563,2822,11735,3187,5902,23082,5750,34734,16990,17744,0.4891,0.5109,0.1699,0.6645,0.1655,986.48
1115,2020,Camós,168,15.66,Pla de l'Estany,Interior,Banyoles,11,Girona,56,209,75,36,200,101,92,409,176,677,340,337,0.5022,0.4978,0.1359,0.6041,0.26,43.23
1116,2020,Campdevànol,738,32.62,Ripollès,Pirineu,Ripoll,19,Girona,201,991,368,207,964,501,408,1955,869,3232,1560,1672,0.4827,0.5173,0.1262,0.6049,0.2689,99.08
1117,2020,Campelles,1303,18.64,Ripollès,Pirineu,Ripoll,19,Girona,6,47,20,4,47,16,10,94,36,140,73,67,0.5214,0.4786,0.0714,0.6714,0.2571,7.51
1118,2020,Campins,321,7.29,Vallès Oriental,Interior,Granollers,39,Barcelona,34,206,43,41,176,41,75,382,84,541,283,258,0.5231,0.4769,0.1386,0.7061,0.1553,74.21
1119,2020,Campllong,113,8.59,Gironès,Interior,Girona,27,Girona,57,182,25,59,177,37,116,359,62,537,264,273,0.4916,0.5084,0.216,0.6685,0.1155,62.51
1120,2020,Camprodon,947,103.38,Ripollès,Pirineu,Ripoll,19,Girona,138,707,279,134,704,336,272,1411,615,2298,1124,1174,0.4891,0.5109,0.1184,0.614,0.2676,22.23
1121,2020,Canejan,906,48.32,Val d'Aran,Pirineu,Vielha,9,Lleida,1,31,13,5,31,8,6,62,21,89,45,44,0.5056,0.4944,0.0674,0.6966,0.236,1.84
1122,2020,Canet d'Adri,217,44.41,Gironès,Interior,Girona,27,Girona,67,236,79,56,212,79,123,448,158,729,382,347,0.524,0.476,0.1687,0.6145,0.2167,16.42
1123,2020,Canet de Mar,15,5.56,Maresme,Costal,Mataró,30,Barcelona,1161,4795,1338,1024,4723,1824,2185,9518,3162,14865,7294,7571,0.4907,0.5093,0.147,0.6403,0.2127,2673.56
1124,2020,"Canonja, la",50,7.32,Tarragonès,Costal,Tarragona,22,Tarragona,533,1967,412,519,2019,506,1052,3986,918,5956,2912,3044,0.4889,0.5111,0.1766,0.6692,0.1541,813.66
1125,2020,Canovelles,175,6.66,Vallès Oriental,Interior,Granollers,39,Barcelona,1584,5918,1191,1438,5272,1426,3022,11190,2617,16829,8693,8136,0.5165,0.4835,0.1796,0.6649,0.1555,2526.88
1126,2020,Cànoves i Samalús,346,29.19,Vallès Oriental,Interior,Granollers,39,Barcelona,270,1082,259,244,1026,275,514,2108,534,3156,1611,1545,0.5105,0.4895,0.1629,0.6679,0.1692,108.12
1127,2020,Cantallops,200,19.62,Alt Empordà,Costal,Figueres,68,Girona,18,95,40,23,89,44,41,184,84,309,153,156,0.4951,0.5049,0.1327,0.5955,0.2718,15.75
1128,2020,Canyelles,142,14.23,Garraf,Costal,Vilanova i la Geltrú,6,Barcelona,396,1674,360,357,1558,354,753,3232,714,4699,2430,2269,0.5171,0.4829,0.1602,0.6878,0.1519,330.22
1129,2020,Capafonts,751,13.35,Baix Camp,Costal,Reus,28,Tarragona,3,39,16,6,33,14,9,72,30,111,58,53,0.5225,0.4775,0.0811,0.6486,0.2703,8.31
1130,2020,Capçanes,223,22.49,Priorat,Interior,Falset,23,Tarragona,17,124,56,24,116,55,41,240,111,392,197,195,0.5026,0.4974,0.1046,0.6122,0.2832,17.43
1131,2020,Capellades,317,2.94,Anoia,Interior,Igualada,33,Barcelona,396,1757,512,373,1668,636,769,3425,1148,5342,2665,2677,0.4989,0.5011,0.144,0.6411,0.2149,1817.01
1132,2020,Capmany,107,26.4,Alt Empordà,Costal,Figueres,68,Girona,39,201,65,41,189,76,80,390,141,611,305,306,0.4992,0.5008,0.1309,0.6383,0.2308,23.14
1133,2020,Capolat,1279,34.13,Berguedà,Pre-Pirineu,Berga,31,Barcelona,10,21,8,8,29,8,18,50,16,84,39,45,0.4643,0.5357,0.2143,0.5952,0.1905,2.46
1134,2020,Cardedeu,193,12.1,Vallès Oriental,Interior,Granollers,39,Barcelona,1645,6065,1265,1607,6155,1687,3252,12220,2952,18424,8975,9449,0.4871,0.5129,0.1765,0.6633,0.1602,1522.64
1135,2020,Cardona,507,66.7,Bages,Interior,Manresa,30,Barcelona,284,1441,541,307,1349,717,591,2790,1258,4639,2266,2373,0.4885,0.5115,0.1274,0.6014,0.2712,69.55
1136,2020,Carme,351,11.68,Anoia,Interior,Igualada,33,Barcelona,59,269,83,56,230,88,115,499,171,785,411,374,0.5236,0.4764,0.1465,0.6357,0.2178,67.21
1137,2020,Caseres,324,42.9,Terra Alta,Interior,Gandesa,12,Tarragona,6,67,44,12,64,44,18,131,88,237,117,120,0.4937,0.5063,0.0759,0.5527,0.3713,5.52
1138,2020,Cassà de la Selva,137,45.21,Gironès,Interior,Girona,27,Girona,918,3641,734,871,3264,982,1789,6905,1716,10410,5293,5117,0.5085,0.4915,0.1719,0.6633,0.1648,230.26
1139,2020,Casserres,611,29.46,Berguedà,Pre-Pirineu,Berga,31,Barcelona,115,493,195,104,451,230,219,944,425,1588,803,785,0.5057,0.4943,0.1379,0.5945,0.2676,53.9
1140,2020,Castell de l'Areny,954,24.35,Berguedà,Pre-Pirineu,Berga,31,Barcelona,4,24,9,2,26,2,6,50,11,67,37,30,0.5522,0.4478,0.0896,0.7463,0.1642,2.75
1141,2020,Castell de Mur,532,62.42,Pallars Jussà,Pre-Pirineu,Tremp,14,Lleida,9,57,30,5,44,28,14,101,58,173,96,77,0.5549,0.4451,0.0809,0.5838,0.3353,2.77
1142,2020,Castellar de la Ribera,657,60.19,Solsonès,Pre-Pirineu,Solsona,15,Lleida,15,36,15,11,36,18,26,72,33,131,66,65,0.5038,0.4962,0.1985,0.5496,0.2519,2.18
1143,2020,Castellar de n'Hug,1395,47.12,Berguedà,Pre-Pirineu,Berga,31,Barcelona,4,64,16,7,42,23,11,106,39,156,84,72,0.5385,0.4615,0.0705,0.6795,0.25,3.31
1144,2020,Castellar del Riu,920,32.74,Berguedà,Pre-Pirineu,Berga,31,Barcelona,17,61,21,14,48,15,31,109,36,176,99,77,0.5625,0.4375,0.1761,0.6193,0.2045,5.38
1145,2020,Castellar del Vallès,331,44.91,Vallès Occidental,Interior,Sabadell i Terrassa,23,Barcelona,2058,8222,1809,1868,8240,2291,3926,16462,4100,24488,12089,12399,0.4937,0.5063,0.1603,0.6722,0.1674,545.27
1146,2020,Castellbell i el Vilar,178,28.47,Bages,Interior,Manresa,30,Barcelona,255,1323,323,286,1153,379,541,2476,702,3719,1901,1818,0.5112,0.4888,0.1455,0.6658,0.1888,130.63
1147,2020,Castellbisbal,132,31.03,Vallès Occidental,Interior,Sabadell i Terrassa,23,Barcelona,1137,4392,778,1086,4218,928,2223,8610,1706,12539,6307,6232,0.503,0.497,0.1773,0.6867,0.1361,404.09
1148,2020,Castellcir,773,34.18,Moianès,Interior,Moià,10,Barcelona,65,276,56,67,234,44,132,510,100,742,397,345,0.535,0.465,0.1779,0.6873,0.1348,21.71
1149,2020,Castelldans,353,65.1,Garrigues,Interior,"Borges Blanques, les",24,Lleida,53,341,103,58,260,115,111,601,218,930,497,433,0.5344,0.4656,0.1194,0.6462,0.2344,14.29
1150,2020,Castelldefels,3,12.87,Baix Llobregat,Costal,St. Feliu de Llobregat,30,Barcelona,5625,23216,4321,5178,23335,5785,10803,46551,10106,67460,33162,34298,0.4916,0.5084,0.1601,0.6901,0.1498,5241.65
1151,2020,Castellet i la Gornal,137,47.48,Alt Penedès,Interior,Vilafranca del Penedès,27,Barcelona,167,853,219,165,731,247,332,1584,466,2382,1239,1143,0.5202,0.4798,0.1394,0.665,0.1956,50.17
1152,2020,Castellfollit de la Roca,296,0.73,Garrotxa,Pre-Pirineu,Olot,21,Girona,82,293,113,52,273,134,134,566,247,947,488,459,0.5153,0.4847,0.1415,0.5977,0.2608,1297.26
1153,2020,Castellfollit de Riubregós,467,26.21,Anoia,Interior,Igualada,33,Barcelona,6,60,25,8,37,26,14,97,51,162,91,71,0.5617,0.4383,0.0864,0.5988,0.3148,6.18
1154,2020,Castellfollit del Boix,700,58.9,Bages,Interior,Manresa,30,Barcelona,37,153,38,36,129,54,73,282,92,447,228,219,0.5101,0.4899,0.1633,0.6309,0.2058,7.59
1155,2020,Castellgalí,266,17.21,Bages,Interior,Manresa,30,Barcelona,199,710,193,174,637,206,373,1347,399,2119,1102,1017,0.5201,0.4799,0.176,0.6357,0.1883,123.13
1156,2020,Castellnou de Bages,469,29.16,Bages,Interior,Manresa,30,Barcelona,132,546,92,128,448,91,260,994,183,1437,770,667,0.5358,0.4642,0.1809,0.6917,0.1273,49.28
1157,2020,Castellnou de Seana,269,16.11,Pla d'Urgell,Interior,Mollerussa,16,Lleida,48,213,93,42,167,102,90,380,195,665,354,311,0.5323,0.4677,0.1353,0.5714,0.2932,41.28
1158,2020,Castelló d'Empúries,17,42.3,Alt Empordà,Costal,Figueres,68,Girona,860,3762,982,871,3575,1050,1731,7337,2032,11100,5604,5496,0.5049,0.4951,0.1559,0.661,0.1831,262.41
1159,2020,Castelló de Farfanya,358,52.62,Noguera,Interior,Balaguer,30,Lleida,32,190,69,34,138,76,66,328,145,539,291,248,0.5399,0.4601,0.1224,0.6085,0.269,10.24
1160,2020,Castellolí,415,25.28,Anoia,Interior,Igualada,33,Barcelona,43,209,50,81,187,56,124,396,106,626,302,324,0.4824,0.5176,0.1981,0.6326,0.1693,24.76
1161,2020,Castell-Platja d'Aro,5,21.75,Baix Empordà,Costal,"Bisbal d'Empordà, la",36,Girona,796,3629,1001,769,3674,1161,1565,7303,2162,11030,5426,5604,0.4919,0.5081,0.1419,0.6621,0.196,507.13
1162,2020,Castellserà,267,15.84,Urgell,Interior,Tàrrega,20,Lleida,60,323,122,58,274,159,118,597,281,996,505,491,0.507,0.493,0.1185,0.5994,0.2821,62.88
1163,2020,Castellterçol,726,31.9,Moianès,Interior,Moià,10,Barcelona,159,859,257,165,773,335,324,1632,592,2548,1275,1273,0.5004,0.4996,0.1272,0.6405,0.2323,79.87
1164,2020,Castellvell del Camp,219,5.21,Baix Camp,Costal,Reus,28,Tarragona,236,965,216,209,992,210,445,1957,426,2828,1417,1411,0.5011,0.4989,0.1574,0.692,0.1506,542.8
1165,2020,Castellví de la Marca,198,28.4,Alt Penedès,Interior,Vilafranca del Penedès,27,Barcelona,108,525,162,105,493,182,213,1018,344,1575,795,780,0.5048,0.4952,0.1352,0.6463,0.2184,55.46
1166,2020,Castellví de Rosanes,178,16.38,Baix Llobregat,Costal,St. Feliu de Llobregat,30,Barcelona,140,682,127,166,646,172,306,1328,299,1933,949,984,0.4909,0.5091,0.1583,0.687,0.1547,118.01
1167,2020,"Catllar, el",59,26.43,Tarragonès,Costal,Tarragona,22,Tarragona,412,1605,349,347,1509,335,759,3114,684,4557,2366,2191,0.5192,0.4808,0.1666,0.6833,0.1501,172.42
1168,2020,Cava,1335,42.19,Alt Urgell,Pirineu,"Seu d'Urgell, la",19,Lleida,2,19,8,1,8,7,3,27,15,45,29,16,0.6444,0.3556,0.0667,0.6,0.3333,1.07
1169,2020,"Cellera de Ter, la",166,14.63,Selva,Costal,Sta. Coloma de Farners,26,Girona,143,613,203,136,602,253,279,1215,456,1950,959,991,0.4918,0.5082,0.1431,0.6231,0.2338,133.29
1170,2020,Celrà,71,19.53,Gironès,Interior,Girona,27,Girona,586,1938,272,578,1876,311,1164,3814,583,5561,2796,2765,0.5028,0.4972,0.2093,0.6858,0.1048,284.74
1171,2020,Centelles,496,15.18,Osona,Interior,Vic,50,Barcelona,605,2485,606,564,2398,855,1169,4883,1461,7513,3696,3817,0.4919,0.5081,0.1556,0.6499,0.1945,494.93
1172,2020,Cercs,650,47.35,Berguedà,Pre-Pirineu,Berga,31,Barcelona,63,371,134,56,330,196,119,701,330,1150,568,582,0.4939,0.5061,0.1035,0.6096,0.287,24.29
1173,2020,Cerdanyola del Vallès,82,30.56,Vallès Occidental,Interior,Sabadell i Terrassa,23,Barcelona,4151,19131,5002,3816,19443,6312,7967,38574,11314,57855,28284,29571,0.4889,0.5111,0.1377,0.6667,0.1956,1893.16
1174,2020,Cervelló,122,24.1,Baix Llobregat,Costal,St. Feliu de Llobregat,30,Barcelona,773,3087,711,703,2932,871,1476,6019,1582,9077,4571,4506,0.5036,0.4964,0.1626,0.6631,0.1743,376.64
1175,2020,Cervera,548,55.19,Segarra,Interior,Cervera,21,Lleida,796,3301,681,763,2960,849,1559,6261,1530,9350,4778,4572,0.511,0.489,0.1667,0.6696,0.1636,169.41
1176,2020,Cervià de les Garrigues,444,34.2,Garrigues,Interior,"Borges Blanques, les",24,Lleida,33,217,100,32,176,104,65,393,204,662,350,312,0.5287,0.4713,0.0982,0.5937,0.3082,19.36
1177,2020,Cervià de Ter,45,9.9,Gironès,Interior,Girona,27,Girona,93,314,87,76,311,85,169,625,172,966,494,472,0.5114,0.4886,0.1749,0.647,0.1781,97.58
1178,2020,Cistella,130,25.55,Alt Empordà,Costal,Figueres,68,Girona,16,89,32,21,94,30,37,183,62,282,137,145,0.4858,0.5142,0.1312,0.6489,0.2199,11.04
1179,2020,Ciutadilla,519,17.03,Urgell,Interior,Tàrrega,20,Lleida,12,66,33,12,53,32,24,119,65,208,111,97,0.5337,0.4663,0.1154,0.5721,0.3125,12.21
1180,2020,Clariana de Cardener,500,40.78,Solsonès,Pre-Pirineu,Solsona,15,Lleida,12,57,17,9,53,13,21,110,30,161,86,75,0.5342,0.4658,0.1304,0.6832,0.1863,3.95
1181,2020,"Cogul, el",279,17.51,Garrigues,Interior,"Borges Blanques, les",24,Lleida,5,49,29,2,39,27,7,88,56,151,83,68,0.5497,0.4503,0.0464,0.5828,0.3709,8.62
1182,2020,Colera,10,24.35,Alt Empordà,Costal,Figueres,68,Girona,12,134,71,21,133,74,33,267,145,445,217,228,0.4876,0.5124,0.0742,0.6,0.3258,18.28
1183,2020,Coll de Nargó,573,151.41,Alt Urgell,Pirineu,"Seu d'Urgell, la",19,Lleida,33,165,79,26,160,77,59,325,156,540,277,263,0.513,0.487,0.1093,0.6019,0.2889,3.57
1184,2020,Collbató,388,18.07,Baix Llobregat,Costal,St. Feliu de Llobregat,30,Barcelona,434,1621,304,361,1495,329,795,3116,633,4544,2359,2185,0.5191,0.4809,0.175,0.6857,0.1393,251.47
1185,2020,Colldejou,431,14.48,Baix Camp,Costal,Reus,28,Tarragona,11,61,21,7,45,23,18,106,44,168,93,75,0.5536,0.4464,0.1071,0.631,0.2619,11.6
1186,2020,Collsuspina,901,15.06,Moianès,Interior,Moià,10,Barcelona,33,111,39,36,109,31,69,220,70,359,183,176,0.5097,0.4903,0.1922,0.6128,0.195,23.84
1187,2020,Colomers,41,4.35,Baix Empordà,Costal,"Bisbal d'Empordà, la",36,Girona,7,56,21,11,51,28,18,107,49,174,84,90,0.4828,0.5172,0.1034,0.6149,0.2816,40.0
1188,2020,"Coma i la Pedra, la",1004,60.62,Solsonès,Pre-Pirineu,Solsona,15,Lleida,14,107,30,9,72,23,23,179,53,255,151,104,0.5922,0.4078,0.0902,0.702,0.2078,4.21
1189,2020,Conca de Dalt,507,166.48,Pallars Jussà,Pre-Pirineu,Tremp,14,Lleida,23,116,70,27,110,64,50,226,134,410,209,201,0.5098,0.4902,0.122,0.5512,0.3268,2.46
1190,2020,Conesa,705,29.02,Conca de Barberà,Interior,Montblanc,22,Tarragona,6,31,13,2,32,16,8,63,29,100,50,50,0.5,0.5,0.08,0.63,0.29,3.45
1191,2020,Constantí,81,30.87,Tarragonès,Costal,Tarragona,22,Tarragona,645,2335,465,611,2101,508,1256,4436,973,6665,3445,3220,0.5169,0.4831,0.1884,0.6656,0.146,215.91
1192,2020,Copons,432,18.66,Anoia,Interior,Igualada,33,Barcelona,26,97,34,33,91,40,59,188,74,321,157,164,0.4891,0.5109,0.1838,0.5857,0.2305,17.2
1193,2020,Corbera d'Ebre,337,53.09,Terra Alta,Interior,Gandesa,12,Tarragona,63,339,127,43,284,147,106,623,274,1003,529,474,0.5274,0.4726,0.1057,0.6211,0.2732,18.89
1194,2020,Corbera de Llobregat,342,18.41,Baix Llobregat,Costal,St. Feliu de Llobregat,30,Barcelona,1240,5240,974,1171,5060,1197,2411,10300,2171,14882,7454,7428,0.5009,0.4991,0.162,0.6921,0.1459,808.37
1195,2020,Corbins,211,21.01,Segrià,Costal,Lleida,38,Lleida,126,561,124,103,383,165,229,944,289,1462,811,651,0.5547,0.4453,0.1566,0.6457,0.1977,69.59
1196,2020,Corçà,43,16.29,Baix Empordà,Costal,"Bisbal d'Empordà, la",36,Girona,118,382,142,87,385,154,205,767,296,1268,642,626,0.5063,0.4937,0.1617,0.6049,0.2334,77.84
1197,2020,Cornellà de Llobregat,27,6.99,Baix Llobregat,Costal,St. Feliu de Llobregat,30,Barcelona,6664,29437,7521,6409,29455,10450,13073,58892,17971,89936,43622,46314,0.485,0.515,0.1454,0.6548,0.1998,12866.38
1198,2020,Cornellà del Terri,96,27.71,Pla de l'Estany,Interior,Banyoles,11,Girona,212,774,229,191,750,243,403,1524,472,2399,1215,1184,0.5065,0.4935,0.168,0.6353,0.1967,86.58
1199,2020,Cornudella de Montsant,533,63.5,Priorat,Interior,Falset,23,Tarragona,46,360,95,51,276,116,97,636,211,944,501,443,0.5307,0.4693,0.1028,0.6737,0.2235,14.87
1200,2020,Creixell,48,10.46,Tarragonès,Costal,Tarragona,22,Tarragona,286,1206,403,255,1133,475,541,2339,878,3758,1895,1863,0.5043,0.4957,0.144,0.6224,0.2336,359.27
1201,2020,Crespià,138,11.38,Pla de l'Estany,Interior,Banyoles,11,Girona,15,87,25,19,74,34,34,161,59,254,127,127,0.5,0.5,0.1339,0.6339,0.2323,22.32
1202,2020,"Cruïlles, Monells i Sant Sadurní de l'Heura",110,99.84,Baix Empordà,Costal,"Bisbal d'Empordà, la",36,Girona,88,418,126,88,419,131,176,837,257,1270,632,638,0.4976,0.5024,0.1386,0.6591,0.2024,12.72
1203,2020,Cubelles,12,13.49,Garraf,Costal,Vilanova i la Geltrú,6,Barcelona,1359,5324,1261,1239,5154,1433,2598,10478,2694,15770,7944,7826,0.5037,0.4963,0.1647,0.6644,0.1708,1169.01
1204,2020,Cubells,499,39.17,Noguera,Interior,Balaguer,30,Lleida,15,112,52,11,90,58,26,202,110,338,179,159,0.5296,0.4704,0.0769,0.5976,0.3254,8.63
1205,2020,Cunit,10,9.74,Baix Penedès,Costal,"Vendrell, el",14,Tarragona,989,4239,1422,1012,4237,1634,2001,8476,3056,13533,6650,6883,0.4914,0.5086,0.1479,0.6263,0.2258,1389.43
1206,2020,Darnius,193,34.93,Alt Empordà,Costal,Figueres,68,Girona,25,183,64,31,157,77,56,340,141,537,272,265,0.5065,0.4935,0.1043,0.6331,0.2626,15.37
1207,2020,Das,1219,14.58,Cerdanya,Pirineu,Puigcerdà,17,Girona,18,83,20,26,67,20,44,150,40,234,121,113,0.5171,0.4829,0.188,0.641,0.1709,16.05
1208,2020,Deltebre,6,107.44,Baix Ebre,Costal,Tortosa,14,Tarragona,828,3864,1157,770,3550,1409,1598,7414,2566,11578,5849,5729,0.5052,0.4948,0.138,0.6404,0.2216,107.76
1209,2020,Dosrius,147,40.73,Maresme,Costal,Mataró,30,Barcelona,480,2037,364,469,1894,408,949,3931,772,5652,2881,2771,0.5097,0.4903,0.1679,0.6955,0.1366,138.77
1210,2020,Duesaigües,268,13.58,Baix Camp,Costal,Reus,28,Tarragona,15,98,25,16,62,28,31,160,53,244,138,106,0.5656,0.4344,0.127,0.6557,0.2172,17.97
1211,2020,"Escala, l'",14,16.31,Alt Empordà,Costal,Figueres,68,Girona,713,3373,1101,671,3191,1195,1384,6564,2296,10244,5187,5057,0.5063,0.4937,0.1351,0.6408,0.2241,628.08
1212,2020,Esparreguera,187,27.4,Baix Llobregat,Costal,St. Feliu de Llobregat,30,Barcelona,1794,7789,1690,1692,7276,2061,3486,15065,3751,22302,11273,11029,0.5055,0.4945,0.1563,0.6755,0.1682,813.94
1213,2020,Espinelves,752,17.43,Osona,Interior,Vic,50,Barcelona,13,79,20,18,65,26,31,144,46,221,112,109,0.5068,0.4932,0.1403,0.6516,0.2081,12.68
1214,2020,"Espluga Calba, l'",434,21.53,Garrigues,Interior,"Borges Blanques, les",24,Lleida,15,98,55,17,84,60,32,182,115,329,168,161,0.5106,0.4894,0.0973,0.5532,0.3495,15.28
1215,2020,"Espluga de Francolí, l'",411,56.97,Conca de Barberà,Interior,Montblanc,22,Tarragona,241,1237,352,253,1169,484,494,2406,836,3736,1830,1906,0.4898,0.5102,0.1322,0.644,0.2238,65.58
1216,2020,Esplugues de Llobregat,110,4.6,Baix Llobregat,Costal,St. Feliu de Llobregat,30,Barcelona,3372,14419,4670,3161,15291,6237,6533,29710,10907,47150,22461,24689,0.4764,0.5236,0.1386,0.6301,0.2313,10250.0
1217,2020,Espolla,124,43.55,Alt Empordà,Costal,Figueres,68,Girona,28,115,61,18,125,65,46,240,126,412,204,208,0.4951,0.5049,0.1117,0.5825,0.3058,9.46
1218,2020,Esponellà,142,16.06,Pla de l'Estany,Interior,Banyoles,11,Girona,45,135,54,41,129,59,86,264,113,463,234,229,0.5054,0.4946,0.1857,0.5702,0.2441,28.83
1219,2020,Espot,1318,97.3,Pallars Sobirà,Pirineu,Sort,15,Lleida,16,143,38,23,114,32,39,257,70,366,197,169,0.5383,0.4617,0.1066,0.7022,0.1913,3.76
1220,2020,"Espunyola, l'",803,35.46,Berguedà,Pre-Pirineu,Berga,31,Barcelona,15,76,29,12,76,34,27,152,63,242,120,122,0.4959,0.5041,0.1116,0.6281,0.2603,6.82
1221,2020,"Esquirol, l'",693,61.8,Osona,Interior,Vic,50,Barcelona,137,717,244,139,675,274,276,1392,518,2186,1098,1088,0.5023,0.4977,0.1263,0.6368,0.237,35.37
1222,2020,Estamariu,1084,21.16,Alt Urgell,Pirineu,"Seu d'Urgell, la",19,Lleida,9,38,25,8,31,14,17,69,39,125,72,53,0.576,0.424,0.136,0.552,0.312,5.91
1223,2020,"Estany, l'",870,10.25,Moianès,Interior,Moià,10,Barcelona,35,129,51,16,109,68,51,238,119,408,215,193,0.527,0.473,0.125,0.5833,0.2917,39.8
1224,2020,Estaràs,596,20.99,Segarra,Interior,Cervera,21,Lleida,5,43,31,12,46,19,17,89,50,156,79,77,0.5064,0.4936,0.109,0.5705,0.3205,7.43
1225,2020,Esterri d'Àneu,957,8.49,Pallars Sobirà,Pirineu,Sort,15,Lleida,47,284,51,55,292,75,102,576,126,804,382,422,0.4751,0.5249,0.1269,0.7164,0.1567,94.7
1226,2020,Esterri de Cardós,1212,16.55,Pallars Sobirà,Pirineu,Sort,15,Lleida,5,23,6,5,19,6,10,42,12,64,34,30,0.5312,0.4688,0.1562,0.6562,0.1875,3.87
1227,2020,Falset,364,31.62,Priorat,Interior,Falset,23,Tarragona,229,864,266,200,831,345,429,1695,611,2735,1359,1376,0.4969,0.5031,0.1569,0.6197,0.2234,86.5
1228,2020,"Far d'Empordà, el",44,9.0,Alt Empordà,Costal,Figueres,68,Girona,51,211,49,50,182,59,101,393,108,602,311,291,0.5166,0.4834,0.1678,0.6528,0.1794,66.89
1229,2020,Farrera,1294,61.87,Pallars Sobirà,Pirineu,Sort,15,Lleida,6,42,15,6,28,11,12,70,26,108,63,45,0.5833,0.4167,0.1111,0.6481,0.2407,1.75
1230,2020,"Fatarella, la",487,56.52,Terra Alta,Interior,Gandesa,12,Tarragona,36,269,146,49,244,182,85,513,328,926,451,475,0.487,0.513,0.0918,0.554,0.3542,16.38
1231,2020,"Febró, la",754,16.08,Baix Camp,Costal,Reus,28,Tarragona,0,16,9,0,11,4,0,27,13,40,25,15,0.625,0.375,0.0,0.675,0.325,2.49
1232,2020,Figaró-Montmany,330,14.99,Vallès Oriental,Interior,Granollers,39,Barcelona,72,389,98,91,367,125,163,756,223,1142,559,583,0.4895,0.5105,0.1427,0.662,0.1953,76.18
1233,2020,Fígols,1154,29.31,Berguedà,Pre-Pirineu,Berga,31,Barcelona,2,18,6,1,9,7,3,27,13,43,26,17,0.6047,0.3953,0.0698,0.6279,0.3023,1.47
1234,2020,Fígols i Alinyà,602,101.8,Alt Urgell,Pirineu,"Seu d'Urgell, la",19,Lleida,11,89,40,10,59,35,21,148,75,244,140,104,0.5738,0.4262,0.0861,0.6066,0.3074,2.4
1235,2020,"Figuera, la",576,18.69,Priorat,Interior,Falset,23,Tarragona,3,42,17,3,27,22,6,69,39,114,62,52,0.5439,0.4561,0.0526,0.6053,0.3421,6.1
1236,2020,Figueres,39,19.3,Alt Empordà,Costal,Figueres,68,Girona,4319,15967,3077,4020,15581,4271,8339,31548,7348,47235,23363,23872,0.4946,0.5054,0.1765,0.6679,0.1556,2447.41
1237,2020,Figuerola del Camp,474,22.72,Alt Camp,Interior,Valls,23,Tarragona,27,108,29,24,102,39,51,210,68,329,164,165,0.4985,0.5015,0.155,0.6383,0.2067,14.48
1238,2020,Flaçà,34,6.53,Gironès,Interior,Girona,27,Girona,93,368,90,90,352,137,183,720,227,1130,551,579,0.4876,0.5124,0.1619,0.6372,0.2009,173.05
1239,2020,Flix,47,116.9,Ribera d'Ebre,Interior,Móra d'Ebre,14,Tarragona,184,1105,434,159,990,538,343,2095,972,3410,1723,1687,0.5053,0.4947,0.1006,0.6144,0.285,29.17
1240,2020,"Floresta, la",316,5.46,Garrigues,Interior,"Borges Blanques, les",24,Lleida,2,55,19,6,37,21,8,92,40,140,76,64,0.5429,0.4571,0.0571,0.6571,0.2857,25.64
1241,2020,Fogars de la Selva,45,32.12,Selva,Costal,Sta. Coloma de Farners,26,Girona,90,530,137,88,474,150,178,1004,287,1469,757,712,0.5153,0.4847,0.1212,0.6835,0.1954,45.73
1242,2020,Fogars de Montclús,386,39.72,Vallès Oriental,Interior,Granollers,39,Barcelona,47,160,42,44,144,38,91,304,80,475,249,226,0.5242,0.4758,0.1916,0.64,0.1684,11.96
1243,2020,Foixà,85,18.8,Baix Empordà,Costal,"Bisbal d'Empordà, la",36,Girona,11,100,40,15,84,53,26,184,93,303,151,152,0.4983,0.5017,0.0858,0.6073,0.3069,16.12
1244,2020,Folgueroles,552,10.47,Osona,Interior,Vic,50,Barcelona,219,763,168,198,713,204,417,1476,372,2265,1150,1115,0.5077,0.4923,0.1841,0.6517,0.1642,216.33
1245,2020,Fondarella,243,5.43,Pla d'Urgell,Interior,Mollerussa,16,Lleida,51,266,71,56,248,84,107,514,155,776,388,388,0.5,0.5,0.1379,0.6624,0.1997,142.91
1246,2020,Fonollosa,525,51.67,Bages,Interior,Manresa,30,Barcelona,105,495,152,95,467,145,200,962,297,1459,752,707,0.5154,0.4846,0.1371,0.6594,0.2036,28.24
1247,2020,Fontanals de Cerdanya,1180,28.65,Cerdanya,Pirineu,Puigcerdà,17,Girona,20,140,52,30,140,55,50,280,107,437,212,225,0.4851,0.5149,0.1144,0.6407,0.2449,15.25
1248,2020,Fontanilles,29,9.28,Baix Empordà,Costal,"Bisbal d'Empordà, la",36,Girona,9,53,19,8,37,20,17,90,39,146,81,65,0.5548,0.4452,0.1164,0.6164,0.2671,15.73
1249,2020,Fontcoberta,207,17.28,Pla de l'Estany,Interior,Banyoles,11,Girona,135,466,131,117,490,130,252,956,261,1469,732,737,0.4983,0.5017,0.1715,0.6508,0.1777,85.01
1250,2020,Font-rubí,319,37.42,Alt Penedès,Interior,Vilafranca del Penedès,27,Barcelona,101,487,156,100,421,149,201,908,305,1414,744,670,0.5262,0.4738,0.1421,0.6421,0.2157,37.79
1251,2020,Foradada,455,28.55,Noguera,Interior,Balaguer,30,Lleida,15,88,29,10,36,25,25,124,54,203,132,71,0.6502,0.3498,0.1232,0.6108,0.266,7.11
1252,2020,Forallac,51,50.63,Baix Empordà,Costal,"Bisbal d'Empordà, la",36,Girona,119,539,169,119,551,198,238,1090,367,1695,827,868,0.4879,0.5121,0.1404,0.6431,0.2165,33.48
1253,2020,Forès,866,16.03,Conca de Barberà,Interior,Montblanc,22,Tarragona,1,13,12,0,8,9,1,21,21,43,26,17,0.6047,0.3953,0.0233,0.4884,0.4884,2.68
1254,2020,Fornells de la Selva,102,11.86,Gironès,Interior,Girona,27,Girona,278,885,170,242,905,190,520,1790,360,2670,1333,1337,0.4993,0.5007,0.1948,0.6704,0.1348,225.13
1255,2020,Fortià,8,10.76,Alt Empordà,Costal,Figueres,68,Girona,56,267,72,55,251,86,111,518,158,787,395,392,0.5019,0.4981,0.141,0.6582,0.2008,73.14
1256,2020,"Franqueses del Vallès, les",181,29.14,Vallès Oriental,Interior,Granollers,39,Barcelona,1942,7084,1305,1857,6667,1509,3799,13751,2814,20364,10331,10033,0.5073,0.4927,0.1866,0.6753,0.1382,698.83
1257,2020,Freginals,126,17.59,Montsià,Costal,Amposta,12,Tarragona,16,149,41,11,104,64,27,253,105,385,206,179,0.5351,0.4649,0.0701,0.6571,0.2727,21.89
1258,2020,"Fuliola, la",275,11.05,Urgell,Interior,Tàrrega,20,Lleida,98,401,121,106,353,171,204,754,292,1250,620,630,0.496,0.504,0.1632,0.6032,0.2336,113.12
1259,2020,Fulleda,581,16.18,Garrigues,Interior,"Borges Blanques, les",24,Lleida,1,33,19,2,30,17,3,63,36,102,53,49,0.5196,0.4804,0.0294,0.6176,0.3529,6.3
1260,2020,Gaià,481,39.48,Bages,Interior,Manresa,30,Barcelona,14,68,16,14,55,16,28,123,32,183,98,85,0.5355,0.4645,0.153,0.6721,0.1749,4.64
1261,2020,"Galera, la",112,27.47,Montsià,Costal,Amposta,12,Tarragona,49,238,95,39,200,115,88,438,210,736,382,354,0.519,0.481,0.1196,0.5951,0.2853,26.79
1262,2020,Gallifa,502,16.33,Vallès Occidental,Interior,Sabadell i Terrassa,23,Barcelona,10,62,17,5,52,21,15,114,38,167,89,78,0.5329,0.4671,0.0898,0.6826,0.2275,10.23
1263,2020,Gandesa,363,71.15,Terra Alta,Interior,Gandesa,12,Tarragona,243,1024,322,213,912,382,456,1936,704,3096,1589,1507,0.5132,0.4868,0.1473,0.6253,0.2274,43.51
1264,2020,Garcia,73,52.37,Ribera d'Ebre,Interior,Móra d'Ebre,14,Tarragona,33,162,64,33,156,79,66,318,143,527,259,268,0.4915,0.5085,0.1252,0.6034,0.2713,10.06
1265,2020,"Garidells, els",132,3.07,Alt Camp,Interior,Valls,23,Tarragona,9,69,18,12,66,16,21,135,34,190,96,94,0.5053,0.4947,0.1105,0.7105,0.1789,61.89
1266,2020,"Garriga, la",252,18.8,Vallès Oriental,Interior,Granollers,39,Barcelona,1410,5441,1205,1298,5676,1638,2708,11117,2843,16668,8056,8612,0.4833,0.5167,0.1625,0.667,0.1706,886.6
1267,2020,Garrigàs,101,19.89,Alt Empordà,Costal,Figueres,68,Girona,38,156,40,33,143,41,71,299,81,451,234,217,0.5188,0.4812,0.1574,0.663,0.1796,22.67
1268,2020,Garrigoles,92,9.4,Baix Empordà,Costal,"Bisbal d'Empordà, la",36,Girona,13,57,18,15,46,18,28,103,36,167,88,79,0.5269,0.4731,0.1677,0.6168,0.2156,17.77
1269,2020,Garriguella,56,21.01,Alt Empordà,Costal,Figueres,68,Girona,61,268,96,70,263,95,131,531,191,853,425,428,0.4982,0.5018,0.1536,0.6225,0.2239,40.6
1270,2020,Gavà,9,30.75,Baix Llobregat,Costal,St. Feliu de Llobregat,30,Barcelona,3875,15512,3635,3610,15706,4719,7485,31218,8354,47057,23022,24035,0.4892,0.5108,0.1591,0.6634,0.1775,1530.31
1271,2020,Gavet de la Conca,421,90.9,Pallars Jussà,Pre-Pirineu,Tremp,14,Lleida,10,79,42,9,68,53,19,147,95,261,131,130,0.5019,0.4981,0.0728,0.5632,0.364,2.87
1272,2020,Gelida,196,26.69,Alt Penedès,Interior,Vilafranca del Penedès,27,Barcelona,689,2628,525,640,2519,669,1329,5147,1194,7670,3842,3828,0.5009,0.4991,0.1733,0.6711,0.1557,287.37
1273,2020,Ger,1135,33.38,Cerdanya,Pirineu,Puigcerdà,17,Girona,38,140,44,42,140,45,80,280,89,449,222,227,0.4944,0.5056,0.1782,0.6236,0.1982,13.45
1274,2020,Gimenells i el Pla de la Font,258,55.84,Segrià,Costal,Lleida,38,Lleida,80,399,121,72,308,140,152,707,261,1120,600,520,0.5357,0.4643,0.1357,0.6312,0.233,20.06
1275,2020,Ginestar,26,15.84,Ribera d'Ebre,Interior,Móra d'Ebre,14,Tarragona,42,249,116,27,212,118,69,461,234,764,407,357,0.5327,0.4673,0.0903,0.6034,0.3063,48.23
1276,2020,Girona,70,39.12,Gironès,Interior,Girona,27,Girona,8577,34421,6811,8024,35959,9577,16601,70380,16388,103369,49809,53560,0.4819,0.5181,0.1606,0.6809,0.1585,2642.36
1277,2020,Gironella,469,6.78,Berguedà,Pre-Pirineu,Berga,31,Barcelona,399,1506,556,334,1444,707,733,2950,1263,4946,2461,2485,0.4976,0.5024,0.1482,0.5964,0.2554,729.5
1278,2020,Gisclareny,1340,36.47,Berguedà,Pre-Pirineu,Berga,31,Barcelona,2,10,4,0,8,2,2,18,6,26,16,10,0.6154,0.3846,0.0769,0.6923,0.2308,0.71
1279,2020,Godall,168,33.62,Montsià,Costal,Amposta,12,Tarragona,25,174,97,37,165,100,62,339,197,598,296,302,0.495,0.505,0.1037,0.5669,0.3294,17.79
1280,2020,Golmés,275,16.62,Pla d'Urgell,Interior,Mollerussa,16,Lleida,144,640,156,167,574,174,311,1214,330,1855,940,915,0.5067,0.4933,0.1677,0.6544,0.1779,111.61
1281,2020,Gombrèn,919,43.26,Ripollès,Pirineu,Ripoll,19,Girona,21,57,17,14,56,27,35,113,44,192,95,97,0.4948,0.5052,0.1823,0.5885,0.2292,4.44
1282,2020,Gósol,1423,56.29,Berguedà,Pre-Pirineu,Berga,31,Barcelona,10,78,30,7,52,29,17,130,59,206,118,88,0.5728,0.4272,0.0825,0.6311,0.2864,3.66
1283,2020,"Granada, la",272,6.52,Alt Penedès,Interior,Vilafranca del Penedès,27,Barcelona,196,755,146,189,729,193,385,1484,339,2208,1097,1111,0.4968,0.5032,0.1744,0.6721,0.1535,338.65
1284,2020,"Granadella, la",528,88.7,Garrigues,Interior,"Borges Blanques, les",24,Lleida,50,241,101,32,184,108,82,425,209,716,392,324,0.5475,0.4525,0.1145,0.5936,0.2919,8.07
1285,2020,Granera,782,23.73,Moianès,Interior,Moià,10,Barcelona,3,37,12,2,17,6,5,54,18,77,52,25,0.6753,0.3247,0.0649,0.7013,0.2338,3.24
1286,2020,"Granja d'Escarp, la",78,38.51,Segrià,Costal,Lleida,38,Lleida,48,359,102,54,230,129,102,589,231,922,509,413,0.5521,0.4479,0.1106,0.6388,0.2505,23.94
1287,2020,Granollers,145,14.87,Vallès Oriental,Interior,Granollers,39,Barcelona,4780,21335,4776,4482,20594,6452,9262,41929,11228,62419,30891,31528,0.4949,0.5051,0.1484,0.6717,0.1799,4197.65
1288,2020,Granyanella,508,24.35,Segarra,Interior,Cervera,21,Lleida,5,46,29,4,42,17,9,88,46,143,80,63,0.5594,0.4406,0.0629,0.6154,0.3217,5.87
1289,2020,Granyena de les Garrigues,366,20.47,Garrigues,Interior,"Borges Blanques, les",24,Lleida,9,54,22,6,29,20,15,83,42,140,85,55,0.6071,0.3929,0.1071,0.5929,0.3,6.84
1290,2020,Granyena de Segarra,636,16.3,Segarra,Interior,Cervera,21,Lleida,6,50,26,13,31,25,19,81,51,151,82,69,0.543,0.457,0.1258,0.5364,0.3377,9.26
1291,2020,Gratallops,321,13.52,Priorat,Interior,Falset,23,Tarragona,9,90,29,7,65,37,16,155,66,237,128,109,0.5401,0.4599,0.0675,0.654,0.2785,17.53
1292,2020,Gualba,177,23.29,Vallès Oriental,Interior,Granollers,39,Barcelona,155,544,95,155,476,123,310,1020,218,1548,794,754,0.5129,0.4871,0.2003,0.6589,0.1408,66.47
1293,2020,Gualta,15,9.02,Baix Empordà,Costal,"Bisbal d'Empordà, la",36,Girona,37,156,41,27,108,33,64,264,74,402,234,168,0.5821,0.4179,0.1592,0.6567,0.1841,44.57
1294,2020,Guardiola de Berguedà,720,61.73,Berguedà,Pre-Pirineu,Berga,31,Barcelona,45,333,114,55,272,122,100,605,236,941,492,449,0.5228,0.4772,0.1063,0.6429,0.2508,15.24
1295,2020,"Guiamets, els",226,12.14,Priorat,Interior,Falset,23,Tarragona,9,89,35,12,78,55,21,167,90,278,133,145,0.4784,0.5216,0.0755,0.6007,0.3237,22.9
1296,2020,Guils de Cerdanya,1385,22.02,Cerdanya,Pirineu,Puigcerdà,17,Girona,37,203,54,39,165,51,76,368,105,549,294,255,0.5355,0.4645,0.1384,0.6703,0.1913,24.93
1297,2020,Guimerà,555,25.76,Urgell,Interior,Tàrrega,20,Lleida,10,86,45,16,59,55,26,145,100,271,141,130,0.5203,0.4797,0.0959,0.5351,0.369,10.52
1298,2020,"Guingueta d'Àneu, la",919,108.42,Pallars Sobirà,Pirineu,Sort,15,Lleida,16,100,40,13,83,37,29,183,77,289,156,133,0.5398,0.4602,0.1003,0.6332,0.2664,2.67
1299,2020,Guissona,484,18.1,Segarra,Interior,Cervera,21,Lleida,742,2846,305,636,2321,398,1378,5167,703,7248,3893,3355,0.5371,0.4629,0.1901,0.7129,0.097,400.44
1300,2020,Guixers,840,66.44,Solsonès,Pre-Pirineu,Solsona,15,Lleida,8,48,24,4,29,19,12,77,43,132,80,52,0.6061,0.3939,0.0909,0.5833,0.3258,1.99
1301,2020,Gurb,516,51.57,Osona,Interior,Vic,50,Barcelona,227,958,214,207,863,244,434,1821,458,2713,1399,1314,0.5157,0.4843,0.16,0.6712,0.1688,52.61
1302,2020,Horta de Sant Joan,542,118.99,Terra Alta,Interior,Gandesa,12,Tarragona,74,366,159,56,312,179,130,678,338,1146,599,547,0.5227,0.4773,0.1134,0.5916,0.2949,9.63
1303,2020,"Hospitalet de Llobregat, l'",8,12.4,Barcelonès,Costal,Barcelona,5,Barcelona,19303,88420,22566,18192,89701,31200,37495,178121,53766,269382,130289,139093,0.4837,0.5163,0.1392,0.6612,0.1996,21724.35
1304,2020,"Hostalets de Pierola, els",361,33.49,Anoia,Interior,Igualada,33,Barcelona,257,1070,191,246,984,232,503,2054,423,2980,1518,1462,0.5094,0.4906,0.1688,0.6893,0.1419,88.98
1305,2020,Hostalric,189,3.39,Selva,Costal,Sta. Coloma de Farners,26,Girona,382,1447,329,358,1353,422,740,2800,751,4291,2158,2133,0.5029,0.4971,0.1725,0.6525,0.175,1265.78
1306,2020,Igualada,313,8.11,Anoia,Interior,Igualada,33,Barcelona,3418,13219,3436,3225,12764,4680,6643,25983,8116,40742,20073,20669,0.4927,0.5073,0.1631,0.6377,0.1992,5023.67
1307,2020,Isona i Conca Dellà,659,139.37,Pallars Jussà,Pre-Pirineu,Tremp,14,Lleida,62,336,164,51,266,163,113,602,327,1042,562,480,0.5393,0.4607,0.1084,0.5777,0.3138,7.48
1308,2020,Isòvol,1088,10.81,Cerdanya,Pirineu,Puigcerdà,17,Girona,23,105,35,19,72,27,42,177,62,281,163,118,0.5801,0.4199,0.1495,0.6299,0.2206,25.99
1309,2020,Ivars d'Urgell,265,24.32,Pla d'Urgell,Interior,Mollerussa,16,Lleida,100,504,202,105,380,246,205,884,448,1537,806,731,0.5244,0.4756,0.1334,0.5751,0.2915,63.2
1310,2020,Ivars de Noguera,314,27.14,Noguera,Interior,Balaguer,30,Lleida,19,113,41,20,91,48,39,204,89,332,173,159,0.5211,0.4789,0.1175,0.6145,0.2681,12.23
1311,2020,Ivorra,567,15.36,Segarra,Interior,Cervera,21,Lleida,0,44,15,2,26,21,2,70,36,108,59,49,0.5463,0.4537,0.0185,0.6481,0.3333,7.03
1312,2020,Jafre,44,6.64,Baix Empordà,Costal,"Bisbal d'Empordà, la",36,Girona,30,132,47,19,101,58,49,233,105,387,209,178,0.5401,0.4599,0.1266,0.6021,0.2713,58.28
1313,2020,"Jonquera, la",110,56.93,Alt Empordà,Costal,Figueres,68,Girona,305,1136,220,268,1119,272,573,2255,492,3320,1661,1659,0.5003,0.4997,0.1726,0.6792,0.1482,58.32
1314,2020,Jorba,380,30.9,Anoia,Interior,Igualada,33,Barcelona,72,307,50,63,279,62,135,586,112,833,429,404,0.515,0.485,0.1621,0.7035,0.1345,26.96
1315,2020,Josa i Tuixén,1206,68.16,Alt Urgell,Pirineu,"Seu d'Urgell, la",19,Lleida,2,40,17,3,27,14,5,67,31,103,59,44,0.5728,0.4272,0.0485,0.6505,0.301,1.51
1316,2020,Juià,94,8.36,Gironès,Interior,Girona,27,Girona,26,111,26,24,100,32,50,211,58,319,163,156,0.511,0.489,0.1567,0.6614,0.1818,38.16
1317,2020,Juncosa,575,76.49,Garrigues,Interior,"Borges Blanques, les",24,Lleida,10,144,52,24,103,62,34,247,114,395,206,189,0.5215,0.4785,0.0861,0.6253,0.2886,5.16
1318,2020,Juneda,264,47.33,Garrigues,Interior,"Borges Blanques, les",24,Lleida,286,1237,354,233,980,411,519,2217,765,3501,1877,1624,0.5361,0.4639,0.1482,0.6332,0.2185,73.97
1319,2020,Les,634,23.45,Val d'Aran,Pirineu,Vielha,9,Lleida,60,350,54,80,348,79,140,698,133,971,464,507,0.4779,0.5221,0.1442,0.7188,0.137,41.41
1320,2020,Linyola,248,28.66,Pla d'Urgell,Interior,Mollerussa,16,Lleida,191,909,267,205,836,309,396,1745,576,2717,1367,1350,0.5031,0.4969,0.1457,0.6423,0.212,94.8
1321,2020,"Llacuna, la",615,52.23,Anoia,Interior,Igualada,33,Barcelona,57,331,105,57,232,121,114,563,226,903,493,410,0.546,0.454,0.1262,0.6235,0.2503,17.29
1322,2020,Lladó,197,13.5,Alt Empordà,Costal,Figueres,68,Girona,80,263,68,92,276,65,172,539,133,844,411,433,0.487,0.513,0.2038,0.6386,0.1576,62.52
1323,2020,Lladorre,1052,146.98,Pallars Sobirà,Pirineu,Sort,15,Lleida,13,77,29,13,72,33,26,149,62,237,119,118,0.5021,0.4979,0.1097,0.6287,0.2616,1.61
1324,2020,Lladurs,834,128.03,Solsonès,Pre-Pirineu,Solsona,15,Lleida,8,56,31,11,53,21,19,109,52,180,95,85,0.5278,0.4722,0.1056,0.6056,0.2889,1.41
1325,2020,"Llagosta, la",45,3.03,Vallès Oriental,Interior,Granollers,39,Barcelona,1057,4515,1119,1062,4357,1477,2119,8872,2596,13587,6691,6896,0.4925,0.5075,0.156,0.653,0.1911,4484.16
1326,2020,Llagostera,160,76.38,Gironès,Interior,Girona,27,Girona,748,2973,652,734,2722,818,1482,5695,1470,8647,4373,4274,0.5057,0.4943,0.1714,0.6586,0.17,113.21
1327,2020,Llambilles,143,14.58,Gironès,Interior,Girona,27,Girona,61,244,61,48,231,68,109,475,129,713,366,347,0.5133,0.4867,0.1529,0.6662,0.1809,48.9
1328,2020,Llanars,983,24.73,Ripollès,Pirineu,Ripoll,19,Girona,36,163,75,34,161,66,70,324,141,535,274,261,0.5121,0.4879,0.1308,0.6056,0.2636,21.63
1329,2020,Llançà,4,27.98,Alt Empordà,Costal,Figueres,68,Girona,328,1559,466,304,1511,607,632,3070,1073,4775,2353,2422,0.4928,0.5072,0.1324,0.6429,0.2247,170.66
1330,2020,Llardecans,397,66.04,Segrià,Costal,Lleida,38,Lleida,23,141,73,15,113,79,38,254,152,444,237,207,0.5338,0.4662,0.0856,0.5721,0.3423,6.72
1331,2020,Llavorsí,811,68.51,Pallars Sobirà,Pirineu,Sort,15,Lleida,20,118,38,19,114,37,39,232,75,346,176,170,0.5087,0.4913,0.1127,0.6705,0.2168,5.05
1332,2020,Lleida,155,212.3,Segrià,Costal,Lleida,38,Lleida,11042,47974,10525,10463,45670,14729,21505,93644,25254,140403,69541,70862,0.4953,0.5047,0.1532,0.667,0.1799,661.34
1333,2020,Llers,142,21.28,Alt Empordà,Costal,Figueres,68,Girona,81,406,122,93,394,141,174,800,263,1237,609,628,0.4923,0.5077,0.1407,0.6467,0.2126,58.13
1334,2020,Lles de Cerdanya,1471,102.79,Cerdanya,Pirineu,Puigcerdà,17,Girona,17,99,41,14,70,29,31,169,70,270,157,113,0.5815,0.4185,0.1148,0.6259,0.2593,2.63
1335,2020,Lliçà d'Amunt,145,22.33,Vallès Oriental,Interior,Granollers,39,Barcelona,1258,5392,1256,1166,5088,1309,2424,10480,2565,15469,7906,7563,0.5111,0.4889,0.1567,0.6775,0.1658,692.75
1336,2020,Lliçà de Vall,125,10.83,Vallès Oriental,Interior,Granollers,39,Barcelona,516,2191,612,435,2126,617,951,4317,1229,6497,3319,3178,0.5109,0.4891,0.1464,0.6645,0.1892,599.91
1337,2020,Llimiana,790,41.68,Pallars Jussà,Pre-Pirineu,Tremp,14,Lleida,9,49,28,6,35,19,15,84,47,146,86,60,0.589,0.411,0.1027,0.5753,0.3219,3.5
1338,2020,Llinars del Vallès,198,27.63,Vallès Oriental,Interior,Granollers,39,Barcelona,778,3404,809,670,3354,1003,1448,6758,1812,10018,4991,5027,0.4982,0.5018,0.1445,0.6746,0.1809,362.58
1339,2020,Llívia,1224,12.93,Cerdanya,Pirineu,Puigcerdà,17,Girona,91,524,130,100,456,130,191,980,260,1431,745,686,0.5206,0.4794,0.1335,0.6848,0.1817,110.67
1340,2020,"Lloar, el",219,6.64,Priorat,Interior,Falset,23,Tarragona,4,36,16,8,29,12,12,65,28,105,56,49,0.5333,0.4667,0.1143,0.619,0.2667,15.81
1341,2020,Llobera,855,39.23,Solsonès,Pre-Pirineu,Solsona,15,Lleida,18,61,28,7,46,28,25,107,56,188,107,81,0.5691,0.4309,0.133,0.5691,0.2979,4.79
1342,2020,Llorac,648,23.33,Conca de Barberà,Interior,Montblanc,22,Tarragona,3,30,15,4,30,9,7,60,24,91,48,43,0.5275,0.4725,0.0769,0.6593,0.2637,3.9
1343,2020,Llorenç del Penedès,162,4.61,Baix Penedès,Costal,"Vendrell, el",14,Tarragona,199,770,211,174,759,282,373,1529,493,2395,1180,1215,0.4927,0.5073,0.1557,0.6384,0.2058,519.52
1344,2020,Lloret de Mar,5,48.71,Selva,Costal,Sta. Coloma de Farners,26,Girona,3093,14240,2593,2916,13094,3153,6009,27334,5746,39089,19926,19163,0.5098,0.4902,0.1537,0.6993,0.147,802.48
1345,2020,"Llosses, les",895,114.02,Ripollès,Pirineu,Ripoll,19,Girona,20,84,17,14,61,16,34,145,33,212,121,91,0.5708,0.4292,0.1604,0.684,0.1557,1.86
1346,2020,Lluçà,745,52.98,Osona,Interior,Vic,50,Barcelona,21,93,21,32,87,22,53,180,43,276,135,141,0.4891,0.5109,0.192,0.6522,0.1558,5.21
1347,2020,Maçanet de Cabrenys,370,67.91,Alt Empordà,Costal,Figueres,68,Girona,32,229,91,34,196,116,66,425,207,698,352,346,0.5043,0.4957,0.0946,0.6089,0.2966,10.28
1348,2020,Maçanet de la Selva,100,45.58,Selva,Costal,Sta. Coloma de Farners,26,Girona,498,2522,616,552,2196,682,1050,4718,1298,7066,3636,3430,0.5146,0.4854,0.1486,0.6677,0.1837,155.02
1349,2020,Madremanya,177,13.72,Gironès,Interior,Girona,27,Girona,27,83,27,25,95,31,52,178,58,288,137,151,0.4757,0.5243,0.1806,0.6181,0.2014,20.99
1350,2020,Maià de Montcal,241,17.29,Garrotxa,Pre-Pirineu,Olot,21,Girona,28,182,50,32,124,47,60,306,97,463,260,203,0.5616,0.4384,0.1296,0.6609,0.2095,26.78
1351,2020,Maials,395,57.08,Segrià,Costal,Lleida,38,Lleida,41,329,130,45,230,134,86,559,264,909,500,409,0.5501,0.4499,0.0946,0.615,0.2904,15.93
1352,2020,Maldà,428,31.36,Urgell,Interior,Tàrrega,20,Lleida,14,65,30,8,66,44,22,131,74,227,109,118,0.4802,0.5198,0.0969,0.5771,0.326,7.24
1353,2020,Malgrat de Mar,4,8.82,Maresme,Costal,Mataró,30,Barcelona,1341,6312,1676,1272,5932,2239,2613,12244,3915,18772,9329,9443,0.497,0.503,0.1392,0.6522,0.2086,2128.34
1354,2020,Malla,580,11.01,Osona,Interior,Vic,50,Barcelona,24,88,26,19,83,32,43,171,58,272,138,134,0.5074,0.4926,0.1581,0.6287,0.2132,24.7
1355,2020,Manlleu,461,17.23,Osona,Interior,Vic,50,Barcelona,1826,7111,1575,1776,6535,2089,3602,13646,3664,20912,10512,10400,0.5027,0.4973,0.1722,0.6525,0.1752,1213.7
1356,2020,Manresa,238,41.65,Bages,Interior,Manresa,30,Barcelona,6434,25408,6493,6016,24885,9009,12450,50293,15502,78245,38335,39910,0.4899,0.5101,0.1591,0.6428,0.1981,1878.63
1357,2020,Marçà,315,16.06,Priorat,Interior,Falset,23,Tarragona,41,207,64,38,182,68,79,389,132,600,312,288,0.52,0.48,0.1317,0.6483,0.22,37.36
1358,2020,Margalef,379,34.66,Priorat,Interior,Falset,23,Tarragona,5,41,17,4,24,15,9,65,32,106,63,43,0.5943,0.4057,0.0849,0.6132,0.3019,3.06
1359,2020,Marganell,291,13.53,Bages,Interior,Manresa,30,Barcelona,15,86,26,9,91,39,24,177,65,266,127,139,0.4774,0.5226,0.0902,0.6654,0.2444,19.66
1360,2020,Martorell,56,12.76,Baix Llobregat,Costal,St. Feliu de Llobregat,30,Barcelona,2511,10094,2050,2351,9101,2665,4862,19195,4715,28772,14655,14117,0.5093,0.4907,0.169,0.6671,0.1639,2254.86
1361,2020,Martorelles,96,3.61,Vallès Oriental,Interior,Granollers,39,Barcelona,355,1633,447,330,1527,528,685,3160,975,4820,2435,2385,0.5052,0.4948,0.1421,0.6556,0.2023,1335.18
1362,2020,Mas de Barberans,348,78.8,Montsià,Costal,Amposta,12,Tarragona,23,174,84,27,155,101,50,329,185,564,281,283,0.4982,0.5018,0.0887,0.5833,0.328,7.16
1363,2020,Masarac,85,12.55,Alt Empordà,Costal,Figueres,68,Girona,15,112,23,18,89,31,33,201,54,288,150,138,0.5208,0.4792,0.1146,0.6979,0.1875,22.95
1364,2020,Masdenverge,54,14.61,Montsià,Costal,Amposta,12,Tarragona,76,338,132,60,331,134,136,669,266,1071,546,525,0.5098,0.4902,0.127,0.6246,0.2484,73.31
1365,2020,"Masies de Roda, les",468,16.41,Osona,Interior,Vic,50,Barcelona,55,235,78,49,221,81,104,456,159,719,368,351,0.5118,0.4882,0.1446,0.6342,0.2211,43.81
1366,2020,"Masies de Voltregà, les",533,22.35,Osona,Interior,Vic,50,Barcelona,219,1053,277,210,1045,328,429,2098,605,3132,1549,1583,0.4946,0.5054,0.137,0.6699,0.1932,140.13
1367,2020,Masllorenç,304,6.55,Baix Penedès,Costal,"Vendrell, el",14,Tarragona,38,190,46,30,146,55,68,336,101,505,274,231,0.5426,0.4574,0.1347,0.6653,0.2,77.1
1368,2020,"Masnou, el",27,3.39,Maresme,Costal,Mataró,30,Barcelona,1767,7818,1939,1670,7882,2755,3437,15700,4694,23831,11524,12307,0.4836,0.5164,0.1442,0.6588,0.197,7029.79
1369,2020,"Masó, la",115,3.57,Alt Camp,Interior,Valls,23,Tarragona,23,83,42,16,75,41,39,158,83,280,148,132,0.5286,0.4714,0.1393,0.5643,0.2964,78.43
1370,2020,Maspujols,214,3.66,Baix Camp,Costal,Reus,28,Tarragona,83,279,59,64,275,63,147,554,122,823,421,402,0.5115,0.4885,0.1786,0.6731,0.1482,224.86
1371,2020,Masquefa,257,17.06,Anoia,Interior,Igualada,33,Barcelona,801,3347,610,797,3134,713,1598,6481,1323,9402,4758,4644,0.5061,0.4939,0.17,0.6893,0.1407,551.11
1372,2020,"Masroig, el",192,15.51,Priorat,Interior,Falset,23,Tarragona,23,178,72,26,126,67,49,304,139,492,273,219,0.5549,0.4451,0.0996,0.6179,0.2825,31.72
1373,2020,Massalcoreig,94,14.14,Segrià,Costal,Lleida,38,Lleida,22,272,60,28,151,77,50,423,137,610,354,256,0.5803,0.4197,0.082,0.6934,0.2246,43.14
1374,2020,Massanes,164,26.07,Selva,Costal,Sta. Coloma de Farners,26,Girona,81,246,93,73,225,78,154,471,171,796,420,376,0.5276,0.4724,0.1935,0.5917,0.2148,30.53
1375,2020,Massoteres,502,26.11,Segarra,Interior,Cervera,21,Lleida,16,83,18,20,59,16,36,142,34,212,117,95,0.5519,0.4481,0.1698,0.6698,0.1604,8.12
1376,2020,Matadepera,423,25.36,Vallès Occidental,Interior,Sabadell i Terrassa,23,Barcelona,879,3113,764,799,3094,847,1678,6207,1611,9496,4756,4740,0.5008,0.4992,0.1767,0.6536,0.1697,374.45
1377,2020,Mataró,28,22.53,Maresme,Costal,Mataró,30,Barcelona,10698,44027,9751,10038,42008,13139,20736,86035,22890,129661,64476,65185,0.4973,0.5027,0.1599,0.6635,0.1765,5755.04
1378,2020,Mediona,430,47.55,Alt Penedès,Interior,Vilafranca del Penedès,27,Barcelona,205,766,221,184,727,266,389,1493,487,2369,1192,1177,0.5032,0.4968,0.1642,0.6302,0.2056,49.82
1379,2020,Menàrguens,205,20.25,Noguera,Interior,Balaguer,30,Lleida,38,311,96,41,220,107,79,531,203,813,445,368,0.5474,0.4526,0.0972,0.6531,0.2497,40.15
1380,2020,Meranges,1539,37.34,Cerdanya,Pirineu,Puigcerdà,17,Girona,8,38,9,7,29,9,15,67,18,100,55,45,0.55,0.45,0.15,0.67,0.18,2.68
1381,2020,Mieres,286,26.29,Garrotxa,Pre-Pirineu,Olot,21,Girona,24,118,34,24,100,45,48,218,79,345,176,169,0.5101,0.4899,0.1391,0.6319,0.229,13.12
1382,2020,"Milà, el",166,4.13,Alt Camp,Interior,Valls,23,Tarragona,13,61,17,17,59,23,30,120,40,190,91,99,0.4789,0.5211,0.1579,0.6316,0.2105,46.0
1383,2020,Miralcamp,287,14.87,Pla d'Urgell,Interior,Mollerussa,16,Lleida,119,454,144,115,401,152,234,855,296,1385,717,668,0.5177,0.4823,0.169,0.6173,0.2137,93.14
1384,2020,Miravet,43,32.33,Ribera d'Ebre,Interior,Móra d'Ebre,14,Tarragona,56,229,90,42,184,105,98,413,195,706,375,331,0.5312,0.4688,0.1388,0.585,0.2762,21.84
1385,2020,Moià,717,75.31,Moianès,Interior,Moià,10,Barcelona,487,2298,496,482,1991,629,969,4289,1125,6383,3281,3102,0.514,0.486,0.1518,0.6719,0.1762,84.76
1386,2020,"Molar, el",228,22.81,Priorat,Interior,Falset,23,Tarragona,11,101,43,8,75,53,19,176,96,291,155,136,0.5326,0.4674,0.0653,0.6048,0.3299,12.76
1387,2020,Molins de Rei,37,15.94,Baix Llobregat,Costal,St. Feliu de Llobregat,30,Barcelona,2243,8475,1921,2110,8636,2555,4353,17111,4476,25940,12639,13301,0.4872,0.5128,0.1678,0.6596,0.1726,1627.35
1388,2020,Mollerussa,250,7.08,Pla d'Urgell,Interior,Mollerussa,16,Lleida,1342,5274,908,1293,4632,1200,2635,9906,2108,14649,7524,7125,0.5136,0.4864,0.1799,0.6762,0.1439,2069.07
1389,2020,Mollet de Peralada,59,6.04,Alt Empordà,Costal,Figueres,68,Girona,18,58,28,14,48,32,32,106,60,198,104,94,0.5253,0.4747,0.1616,0.5354,0.303,32.78
1390,2020,Mollet del Vallès,65,10.77,Vallès Oriental,Interior,Granollers,39,Barcelona,4015,17411,3984,3786,17341,5063,7801,34752,9047,51600,25410,26190,0.4924,0.5076,0.1512,0.6735,0.1753,4791.09
1391,2020,Molló,1182,43.09,Ripollès,Pirineu,Ripoll,19,Girona,19,104,43,28,88,54,47,192,97,336,166,170,0.494,0.506,0.1399,0.5714,0.2887,7.8
1392,2020,"Molsosa, la",667,26.89,Solsonès,Pre-Pirineu,Solsona,15,Lleida,2,33,16,4,32,17,6,65,33,104,51,53,0.4904,0.5096,0.0577,0.625,0.3173,3.87
1393,2020,Monistrol de Calders,447,21.97,Moianès,Interior,Moià,10,Barcelona,47,241,78,35,218,83,82,459,161,702,366,336,0.5214,0.4786,0.1168,0.6538,0.2293,31.95
1394,2020,Monistrol de Montserrat,161,11.77,Bages,Interior,Manresa,30,Barcelona,256,1074,273,236,969,331,492,2043,604,3139,1603,1536,0.5107,0.4893,0.1567,0.6508,0.1924,266.69
1395,2020,Montagut i Oix,276,93.7,Garrotxa,Pre-Pirineu,Olot,21,Girona,60,337,84,66,294,89,126,631,173,930,481,449,0.5172,0.4828,0.1355,0.6785,0.186,9.93
1396,2020,Montblanc,350,91.07,Conca de Barberà,Interior,Montblanc,22,Tarragona,612,2513,617,510,2344,783,1122,4857,1400,7379,3742,3637,0.5071,0.4929,0.1521,0.6582,0.1897,81.03
1397,2020,Montbrió del Camp,132,10.7,Baix Camp,Costal,Reus,28,Tarragona,304,986,209,271,904,235,575,1890,444,2909,1499,1410,0.5153,0.4847,0.1977,0.6497,0.1526,271.87
1398,2020,Montcada i Reixac,36,23.47,Vallès Occidental,Interior,Sabadell i Terrassa,23,Barcelona,3145,12643,2360,2980,12467,3208,6125,25110,5568,36803,18148,18655,0.4931,0.5069,0.1664,0.6823,0.1513,1568.09
1399,2020,Montclar,728,21.89,Berguedà,Pre-Pirineu,Berga,31,Barcelona,13,42,17,13,41,13,26,83,30,139,72,67,0.518,0.482,0.1871,0.5971,0.2158,6.35
1400,2020,Montellà i Martinet,967,54.95,Cerdanya,Pirineu,Puigcerdà,17,Girona,34,208,76,24,171,65,58,379,141,578,318,260,0.5502,0.4498,0.1003,0.6557,0.2439,10.52
1401,2020,Montesquiu,577,4.94,Osona,Interior,Vic,50,Barcelona,98,321,94,75,317,125,173,638,219,1030,513,517,0.4981,0.5019,0.168,0.6194,0.2126,208.5
1402,2020,Montferrer i Castellbò,732,176.66,Alt Urgell,Pirineu,"Seu d'Urgell, la",19,Lleida,93,343,123,83,297,95,176,640,218,1034,559,475,0.5406,0.4594,0.1702,0.619,0.2108,5.85
1403,2020,Montferri,229,19.15,Alt Camp,Interior,Valls,23,Tarragona,33,133,44,37,121,35,70,254,79,403,210,193,0.5211,0.4789,0.1737,0.6303,0.196,21.04
1404,2020,Montgai,286,28.94,Noguera,Interior,Balaguer,30,Lleida,34,208,100,22,164,115,56,372,215,643,342,301,0.5319,0.4681,0.0871,0.5785,0.3344,22.22
1405,2020,Montgat,20,2.91,Maresme,Costal,Mataró,30,Barcelona,1106,4074,849,990,4131,1050,2096,8205,1899,12200,6029,6171,0.4942,0.5058,0.1718,0.6725,0.1557,4192.44
1406,2020,Montmajor,756,76.49,Berguedà,Pre-Pirineu,Berga,31,Barcelona,42,130,60,40,132,65,82,262,125,469,232,237,0.4947,0.5053,0.1748,0.5586,0.2665,6.13
1407,2020,Montmaneu,709,13.62,Anoia,Interior,Igualada,33,Barcelona,10,45,26,3,44,23,13,89,49,151,81,70,0.5364,0.4636,0.0861,0.5894,0.3245,11.09
1408,2020,"Montmell, el",429,72.8,Baix Penedès,Costal,"Vendrell, el",14,Tarragona,114,575,153,107,490,143,221,1065,296,1582,842,740,0.5322,0.4678,0.1397,0.6732,0.1871,21.73
1409,2020,Montmeló,72,4.0,Vallès Oriental,Interior,Granollers,39,Barcelona,633,2932,755,616,2928,967,1249,5860,1722,8831,4320,4511,0.4892,0.5108,0.1414,0.6636,0.195,2207.75
1410,2020,Montoliu de Lleida,166,7.34,Segrià,Costal,Lleida,38,Lleida,32,167,54,25,136,69,57,303,123,483,253,230,0.5238,0.4762,0.118,0.6273,0.2547,65.8
1411,2020,Montoliu de Segarra,689,29.47,Segarra,Interior,Cervera,21,Lleida,10,63,29,6,51,28,16,114,57,187,102,85,0.5455,0.4545,0.0856,0.6096,0.3048,6.35
1412,2020,Montornès de Segarra,605,12.32,Segarra,Interior,Cervera,21,Lleida,3,25,18,5,26,19,8,51,37,96,46,50,0.4792,0.5208,0.0833,0.5312,0.3854,7.79
1413,2020,Montornès del Vallès,116,10.23,Vallès Oriental,Interior,Granollers,39,Barcelona,1486,5726,1178,1462,5378,1414,2948,11104,2592,16644,8390,8254,0.5041,0.4959,0.1771,0.6671,0.1557,1626.98
1414,2020,Mont-ral,888,34.72,Alt Camp,Interior,Valls,23,Tarragona,11,66,22,9,46,14,20,112,36,168,99,69,0.5893,0.4107,0.119,0.6667,0.2143,4.84
1415,2020,Mont-ras,88,12.31,Baix Empordà,Costal,"Bisbal d'Empordà, la",36,Girona,109,569,173,87,551,191,196,1120,364,1680,851,829,0.5065,0.4935,0.1167,0.6667,0.2167,136.47
1416,2020,Mont-roig del Camp,120,63.32,Baix Camp,Costal,Reus,28,Tarragona,999,4315,1109,896,3986,1155,1895,8301,2264,12460,6423,6037,0.5155,0.4845,0.1521,0.6662,0.1817,196.78
1417,2020,Montseny,528,26.77,Vallès Oriental,Interior,Granollers,39,Barcelona,31,122,34,23,100,41,54,222,75,351,187,164,0.5328,0.4672,0.1538,0.6325,0.2137,13.11
1418,2020,Móra d'Ebre,38,45.12,Ribera d'Ebre,Interior,Móra d'Ebre,14,Tarragona,468,1937,469,403,1777,641,871,3714,1110,5695,2874,2821,0.5047,0.4953,0.1529,0.6522,0.1949,126.22
1419,2020,Móra la Nova,31,15.93,Ribera d'Ebre,Interior,Móra d'Ebre,14,Tarragona,225,1051,291,205,984,352,430,2035,643,3108,1567,1541,0.5042,0.4958,0.1384,0.6548,0.2069,195.1
1420,2020,"Morell, el",104,5.94,Tarragonès,Costal,Tarragona,22,Tarragona,332,1371,214,328,1231,266,660,2602,480,3742,1917,1825,0.5123,0.4877,0.1764,0.6954,0.1283,629.97
1421,2020,"Morera de Montsant, la",743,52.88,Priorat,Interior,Falset,23,Tarragona,8,61,18,12,45,15,20,106,33,159,87,72,0.5472,0.4528,0.1258,0.6667,0.2075,3.01
1422,2020,Muntanyola,807,40.3,Osona,Interior,Vic,50,Barcelona,47,231,50,55,205,44,102,436,94,632,328,304,0.519,0.481,0.1614,0.6899,0.1487,15.68
1423,2020,Mura,454,47.79,Bages,Interior,Manresa,30,Barcelona,16,74,27,17,61,25,33,135,52,220,117,103,0.5318,0.4682,0.15,0.6136,0.2364,4.6
1424,2020,Nalec,487,9.25,Urgell,Interior,Tàrrega,20,Lleida,4,20,22,3,25,16,7,45,38,90,46,44,0.5111,0.4889,0.0778,0.5,0.4222,9.73
1425,2020,Naut Aran,1267,255.75,Val d'Aran,Pirineu,Vielha,9,Lleida,134,677,142,119,639,125,253,1316,267,1836,953,883,0.5191,0.4809,0.1378,0.7168,0.1454,7.18
1426,2020,Navarcles,269,5.52,Bages,Interior,Manresa,30,Barcelona,392,1986,580,405,1950,744,797,3936,1324,6057,2958,3099,0.4884,0.5116,0.1316,0.6498,0.2186,1097.28
1427,2020,Navàs,370,80.62,Bages,Interior,Manresa,30,Barcelona,465,1958,564,447,1881,703,912,3839,1267,6018,2987,3031,0.4963,0.5037,0.1515,0.6379,0.2105,74.65
1428,2020,Navata,145,18.48,Alt Empordà,Costal,Figueres,68,Girona,123,450,119,119,478,138,242,928,257,1427,692,735,0.4849,0.5151,0.1696,0.6503,0.1801,77.22
1429,2020,Navès,610,145.27,Solsonès,Pre-Pirineu,Solsona,15,Lleida,22,97,27,19,87,32,41,184,59,284,146,138,0.5141,0.4859,0.1444,0.6479,0.2077,1.95
1430,2020,"Nou de Berguedà, la",876,25.01,Berguedà,Pre-Pirineu,Berga,31,Barcelona,6,49,29,10,45,23,16,94,52,162,84,78,0.5185,0.4815,0.0988,0.5802,0.321,6.48
1431,2020,"Nou de Gaià, la",93,4.32,Tarragonès,Costal,Tarragona,22,Tarragona,67,180,47,62,189,55,129,369,102,600,294,306,0.49,0.51,0.215,0.615,0.17,138.89
1432,2020,Nulles,231,10.61,Alt Camp,Interior,Valls,23,Tarragona,64,164,46,42,136,57,106,300,103,509,274,235,0.5383,0.4617,0.2083,0.5894,0.2024,47.97
1433,2020,Odèn,1130,114.38,Solsonès,Pre-Pirineu,Solsona,15,Lleida,13,91,48,7,69,30,20,160,78,258,152,106,0.5891,0.4109,0.0775,0.6202,0.3023,2.26
1434,2020,Òdena,421,52.66,Anoia,Interior,Igualada,33,Barcelona,344,1269,268,319,1134,334,663,2403,602,3668,1881,1787,0.5128,0.4872,0.1808,0.6551,0.1641,69.65
1435,2020,Ogassa,951,45.22,Ripollès,Pirineu,Ripoll,19,Girona,16,88,28,14,71,23,30,159,51,240,132,108,0.55,0.45,0.125,0.6625,0.2125,5.31
1436,2020,Olèrdola,189,30.15,Alt Penedès,Interior,Vilafranca del Penedès,27,Barcelona,330,1314,311,302,1202,309,632,2516,620,3768,1955,1813,0.5188,0.4812,0.1677,0.6677,0.1645,124.98
1437,2020,Olesa de Bonesvalls,265,30.79,Alt Penedès,Interior,Vilafranca del Penedès,27,Barcelona,155,671,142,136,588,148,291,1259,290,1840,968,872,0.5261,0.4739,0.1582,0.6842,0.1576,59.76
1438,2020,Olesa de Montserrat,124,16.63,Baix Llobregat,Costal,St. Feliu de Llobregat,30,Barcelona,2174,8152,1732,2012,7870,2204,4186,16022,3936,24144,12058,12086,0.4994,0.5006,0.1734,0.6636,0.163,1451.83
1439,2020,Oliana,469,32.37,Alt Urgell,Pirineu,"Seu d'Urgell, la",19,Lleida,103,557,258,111,545,269,214,1102,527,1843,918,925,0.4981,0.5019,0.1161,0.5979,0.2859,56.94
1440,2020,Oliola,452,86.28,Noguera,Interior,Balaguer,30,Lleida,9,73,27,12,58,24,21,131,51,203,109,94,0.5369,0.4631,0.1034,0.6453,0.2512,2.35
1441,2020,Olius,742,54.84,Solsonès,Pre-Pirineu,Solsona,15,Lleida,114,324,89,86,292,76,200,616,165,981,527,454,0.5372,0.4628,0.2039,0.6279,0.1682,17.89
1442,2020,Olivella,211,38.75,Garraf,Costal,Vilanova i la Geltrú,6,Barcelona,377,1417,260,370,1260,251,747,2677,511,3935,2054,1881,0.522,0.478,0.1898,0.6803,0.1299,101.55
1443,2020,Olost,572,29.37,Osona,Interior,Vic,50,Barcelona,70,374,142,79,378,159,149,752,301,1202,586,616,0.4875,0.5125,0.124,0.6256,0.2504,40.93
1444,2020,Olot,443,29.03,Garrotxa,Pre-Pirineu,Olot,21,Girona,2663,12377,2949,2563,11346,4028,5226,23723,6977,35926,17989,17937,0.5007,0.4993,0.1455,0.6603,0.1942,1237.55
1445,2020,"Oluges, les",528,18.95,Segarra,Interior,Cervera,21,Lleida,10,52,28,5,43,33,15,95,61,171,90,81,0.5263,0.4737,0.0877,0.5556,0.3567,9.02
1446,2020,Olvan,553,35.58,Berguedà,Pre-Pirineu,Berga,31,Barcelona,50,284,85,48,256,135,98,540,220,858,419,439,0.4883,0.5117,0.1142,0.6294,0.2564,24.11
1447,2020,"Omellons, els",385,11.06,Garrigues,Interior,"Borges Blanques, les",24,Lleida,7,64,39,10,48,38,17,112,77,206,110,96,0.534,0.466,0.0825,0.5437,0.3738,18.63
1448,2020,"Omells de na Gaia, els",560,13.48,Urgell,Interior,Tàrrega,20,Lleida,2,50,22,4,37,15,6,87,37,130,74,56,0.5692,0.4308,0.0462,0.6692,0.2846,9.64
1449,2020,Ordis,98,8.55,Alt Empordà,Costal,Figueres,68,Girona,25,123,45,25,109,34,50,232,79,361,193,168,0.5346,0.4654,0.1385,0.6427,0.2188,42.22
1450,2020,Organyà,558,12.53,Alt Urgell,Pirineu,"Seu d'Urgell, la",19,Lleida,53,242,92,35,218,131,88,460,223,771,387,384,0.5019,0.4981,0.1141,0.5966,0.2892,61.53
1451,2020,Orís,576,27.17,Osona,Interior,Vic,50,Barcelona,19,118,27,25,110,23,44,228,50,322,164,158,0.5093,0.4907,0.1366,0.7081,0.1553,11.85
1452,2020,Oristà,468,68.49,Osona,Interior,Vic,50,Barcelona,36,170,76,26,157,84,62,327,160,549,282,267,0.5137,0.4863,0.1129,0.5956,0.2914,8.02
1453,2020,Orpí,375,15.23,Anoia,Interior,Igualada,33,Barcelona,14,54,11,14,45,13,28,99,24,151,79,72,0.5232,0.4768,0.1854,0.6556,0.1589,9.91
1454,2020,Òrrius,259,5.66,Maresme,Costal,Mataró,30,Barcelona,69,265,53,64,249,58,133,514,111,758,387,371,0.5106,0.4894,0.1755,0.6781,0.1464,133.92
1455,2020,Os de Balaguer,463,135.96,Noguera,Interior,Balaguer,30,Lleida,67,328,106,70,309,100,137,637,206,980,501,479,0.5112,0.4888,0.1398,0.65,0.2102,7.21
1456,2020,Osor,340,52.07,Selva,Costal,Sta. Coloma de Farners,26,Girona,30,155,47,16,130,50,46,285,97,428,232,196,0.5421,0.4579,0.1075,0.6659,0.2266,8.22
1457,2020,Ossó de Sió,391,26.29,Urgell,Interior,Tàrrega,20,Lleida,12,60,25,13,62,31,25,122,56,203,97,106,0.4778,0.5222,0.1232,0.601,0.2759,7.72
1458,2020,Pacs del Penedès,201,6.27,Alt Penedès,Interior,Vilafranca del Penedès,27,Barcelona,72,310,81,74,298,83,146,608,164,918,463,455,0.5044,0.4956,0.159,0.6623,0.1786,146.41
1459,2020,Palafolls,16,16.56,Maresme,Costal,Mataró,30,Barcelona,875,3340,599,811,3247,741,1686,6587,1340,9613,4814,4799,0.5008,0.4992,0.1754,0.6852,0.1394,580.5
1460,2020,Palafrugell,64,26.88,Baix Empordà,Costal,"Bisbal d'Empordà, la",36,Girona,2004,7681,1846,1882,7457,2374,3886,15138,4220,23244,11531,11713,0.4961,0.5039,0.1672,0.6513,0.1816,864.73
1461,2020,Palamós,12,13.98,Baix Empordà,Costal,"Bisbal d'Empordà, la",36,Girona,1274,5997,1602,1164,5984,2114,2438,11981,3716,18135,8873,9262,0.4893,0.5107,0.1344,0.6607,0.2049,1297.21
1462,2020,"Palau d'Anglesola, el",250,12.27,Pla d'Urgell,Interior,Mollerussa,16,Lleida,176,727,168,172,678,245,348,1405,413,2166,1071,1095,0.4945,0.5055,0.1607,0.6487,0.1907,176.53
1463,2020,Palau de Santa Eulàlia,86,8.44,Alt Empordà,Costal,Figueres,68,Girona,7,29,15,5,23,11,12,52,26,90,51,39,0.5667,0.4333,0.1333,0.5778,0.2889,10.66
1464,2020,Palau-sator,20,12.39,Baix Empordà,Costal,"Bisbal d'Empordà, la",36,Girona,26,103,40,23,83,35,49,186,75,310,169,141,0.5452,0.4548,0.1581,0.6,0.2419,25.02
1465,2020,Palau-saverdera,78,16.45,Alt Empordà,Costal,Figueres,68,Girona,131,451,156,118,430,170,249,881,326,1456,738,718,0.5069,0.4931,0.171,0.6051,0.2239,88.51
1466,2020,Palau-solità i Plegamans,130,14.93,Vallès Occidental,Interior,Sabadell i Terrassa,23,Barcelona,1148,5009,1132,1185,5036,1382,2333,10045,2514,14892,7289,7603,0.4895,0.5105,0.1567,0.6745,0.1688,997.45
1467,2020,"Pallaresos, els",120,5.13,Tarragonès,Costal,Tarragona,22,Tarragona,489,1684,250,460,1649,318,949,3333,568,4850,2423,2427,0.4996,0.5004,0.1957,0.6872,0.1171,945.42
1468,2020,Pallejà,41,8.3,Baix Llobregat,Costal,St. Feliu de Llobregat,30,Barcelona,1082,3906,806,939,3843,1046,2021,7749,1852,11622,5794,5828,0.4985,0.5015,0.1739,0.6668,0.1594,1400.24
1469,2020,"Palma d'Ebre, la",335,37.92,Ribera d'Ebre,Interior,Móra d'Ebre,14,Tarragona,10,97,58,14,85,74,24,182,132,338,165,173,0.4882,0.5118,0.071,0.5385,0.3905,8.91
1470,2020,"Palma de Cervelló, la",100,5.46,Baix Llobregat,Costal,St. Feliu de Llobregat,30,Barcelona,217,1033,225,233,1013,271,450,2046,496,2992,1475,1517,0.493,0.507,0.1504,0.6838,0.1658,547.99
1471,2020,Palol de Revardit,152,17.98,Pla de l'Estany,Interior,Banyoles,11,Girona,32,143,48,38,135,52,70,278,100,448,223,225,0.4978,0.5022,0.1562,0.6205,0.2232,24.92
1472,2020,Pals,55,25.83,Baix Empordà,Costal,"Bisbal d'Empordà, la",36,Girona,163,810,259,156,737,270,319,1547,529,2395,1232,1163,0.5144,0.4856,0.1332,0.6459,0.2209,92.72
1473,2020,"Papiol, el",135,8.95,Baix Llobregat,Costal,St. Feliu de Llobregat,30,Barcelona,360,1410,293,332,1399,378,692,2809,671,4172,2063,2109,0.4945,0.5055,0.1659,0.6733,0.1608,466.15
1474,2020,Pardines,1226,31.05,Ripollès,Pirineu,Ripoll,19,Girona,12,60,18,10,46,23,22,106,41,169,90,79,0.5325,0.4675,0.1302,0.6272,0.2426,5.44
1475,2020,Parets del Vallès,98,9.12,Vallès Oriental,Interior,Granollers,39,Barcelona,1644,6542,1332,1554,6333,1666,3198,12875,2998,19071,9518,9553,0.4991,0.5009,0.1677,0.6751,0.1572,2091.12
1476,2020,Parlavà,40,6.18,Baix Empordà,Costal,"Bisbal d'Empordà, la",36,Girona,27,122,47,29,111,55,56,233,102,391,196,195,0.5013,0.4987,0.1432,0.5959,0.2609,63.27
1477,2020,Passanant i Belltall,714,27.35,Conca de Barberà,Interior,Montblanc,22,Tarragona,3,59,32,1,32,28,4,91,60,155,94,61,0.6065,0.3935,0.0258,0.5871,0.3871,5.67
1478,2020,Pau,33,10.7,Alt Empordà,Costal,Figueres,68,Girona,35,180,65,31,171,75,66,351,140,557,280,277,0.5027,0.4973,0.1185,0.6302,0.2513,52.06
1479,2020,Paüls,378,43.83,Baix Ebre,Costal,Tortosa,14,Tarragona,34,144,95,29,149,94,63,293,189,545,273,272,0.5009,0.4991,0.1156,0.5376,0.3468,12.43
1480,2020,Pedret i Marzà,22,8.65,Alt Empordà,Costal,Figueres,68,Girona,17,64,16,15,60,19,32,124,35,191,97,94,0.5079,0.4921,0.1675,0.6492,0.1832,22.08
1481,2020,Penelles,276,25.51,Noguera,Interior,Balaguer,30,Lleida,24,168,63,22,99,60,46,267,123,436,255,181,0.5849,0.4151,0.1055,0.6124,0.2821,17.09
1482,2020,"Pera, la",93,11.54,Baix Empordà,Costal,"Bisbal d'Empordà, la",36,Girona,41,139,37,26,130,62,67,269,99,435,217,218,0.4989,0.5011,0.154,0.6184,0.2276,37.69
1483,2020,Perafita,754,19.59,Osona,Interior,Vic,50,Barcelona,29,126,53,20,124,53,49,250,106,405,208,197,0.5136,0.4864,0.121,0.6173,0.2617,20.67
1484,2020,Perafort,125,9.54,Tarragonès,Costal,Tarragona,22,Tarragona,135,449,75,116,405,84,251,854,159,1264,659,605,0.5214,0.4786,0.1986,0.6756,0.1258,132.49
1485,2020,Peralada,32,43.61,Alt Empordà,Costal,Figueres,68,Girona,123,640,174,137,607,217,260,1247,391,1898,937,961,0.4937,0.5063,0.137,0.657,0.206,43.52
1486,2020,Peramola,566,56.17,Alt Urgell,Pirineu,"Seu d'Urgell, la",19,Lleida,14,114,45,18,101,55,32,215,100,347,173,174,0.4986,0.5014,0.0922,0.6196,0.2882,6.18
1487,2020,"Perelló, el",142,100.67,Baix Ebre,Costal,Tortosa,14,Tarragona,206,869,367,206,795,383,412,1664,750,2826,1442,1384,0.5103,0.4897,0.1458,0.5888,0.2654,28.07
1488,2020,Piera,324,57.2,Anoia,Interior,Igualada,33,Barcelona,1337,5705,1211,1238,5145,1498,2575,10850,2709,16134,8253,7881,0.5115,0.4885,0.1596,0.6725,0.1679,282.06
1489,2020,"Piles, les",676,22.39,Conca de Barberà,Interior,Montblanc,22,Tarragona,18,67,29,22,61,13,40,128,42,210,114,96,0.5429,0.4571,0.1905,0.6095,0.2,9.38
1490,2020,Pineda de Mar,10,10.74,Maresme,Costal,Mataró,30,Barcelona,1985,9326,2629,1958,8830,3256,3943,18156,5885,27984,13940,14044,0.4981,0.5019,0.1409,0.6488,0.2103,2605.59
1491,2020,"Pinell de Brai, el",189,56.99,Terra Alta,Interior,Gandesa,12,Tarragona,50,334,129,51,272,172,101,606,301,1008,513,495,0.5089,0.4911,0.1002,0.6012,0.2986,17.69
1492,2020,Pinell de Solsonès,800,91.11,Solsonès,Pre-Pirineu,Solsona,15,Lleida,12,73,28,4,47,29,16,120,57,193,113,80,0.5855,0.4145,0.0829,0.6218,0.2953,2.12
1493,2020,Pinós,823,104.32,Solsonès,Pre-Pirineu,Solsona,15,Lleida,17,96,39,22,77,35,39,173,74,286,152,134,0.5315,0.4685,0.1364,0.6049,0.2587,2.74
1494,2020,Pira,385,8.01,Conca de Barberà,Interior,Montblanc,22,Tarragona,41,178,51,30,153,50,71,331,101,503,270,233,0.5368,0.4632,0.1412,0.6581,0.2008,62.8
1495,2020,"Pla de Santa Maria, el",381,34.99,Alt Camp,Interior,Valls,23,Tarragona,178,835,216,154,713,252,332,1548,468,2348,1229,1119,0.5234,0.4766,0.1414,0.6593,0.1993,67.1
1496,2020,"Pla del Penedès, el",216,9.57,Alt Penedès,Interior,Vilafranca del Penedès,27,Barcelona,110,427,101,123,399,115,233,826,216,1275,638,637,0.5004,0.4996,0.1827,0.6478,0.1694,133.23
1497,2020,"Planes d'Hostoles, les",370,37.5,Garrotxa,Pre-Pirineu,Olot,21,Girona,132,528,206,107,485,254,239,1013,460,1712,866,846,0.5058,0.4942,0.1396,0.5917,0.2687,45.65
1498,2020,Planoles,1136,18.75,Ripollès,Pirineu,Ripoll,19,Girona,24,103,38,17,80,42,41,183,80,304,165,139,0.5428,0.4572,0.1349,0.602,0.2632,16.21
1499,2020,"Plans de Sió, els",412,55.89,Segarra,Interior,Cervera,21,Lleida,19,176,71,23,128,74,42,304,145,491,266,225,0.5418,0.4582,0.0855,0.6191,0.2953,8.79
1500,2020,"Poal, el",216,8.88,Pla d'Urgell,Interior,Mollerussa,16,Lleida,46,225,79,38,195,87,84,420,166,670,350,320,0.5224,0.4776,0.1254,0.6269,0.2478,75.45
1501,2020,"Pobla de Cérvoles, la",663,61.92,Garrigues,Interior,"Borges Blanques, les",24,Lleida,6,72,26,3,46,36,9,118,62,189,104,85,0.5503,0.4497,0.0476,0.6243,0.328,3.05
1502,2020,"Pobla de Claramunt, la",265,18.54,Anoia,Interior,Igualada,33,Barcelona,189,717,204,176,672,227,365,1389,431,2185,1110,1075,0.508,0.492,0.167,0.6357,0.1973,117.85
1503,2020,"Pobla de Lillet, la",843,51.45,Berguedà,Pre-Pirineu,Berga,31,Barcelona,41,327,163,38,295,229,79,622,392,1093,531,562,0.4858,0.5142,0.0723,0.5691,0.3586,21.24
1504,2020,"Pobla de Mafumet, la",98,6.21,Tarragonès,Costal,Tarragona,22,Tarragona,440,1435,142,404,1368,182,844,2803,324,3971,2017,1954,0.5079,0.4921,0.2125,0.7059,0.0816,639.45
1505,2020,"Pobla de Massaluca, la",357,43.4,Terra Alta,Interior,Gandesa,12,Tarragona,19,103,58,12,77,48,31,180,106,317,180,137,0.5678,0.4322,0.0978,0.5678,0.3344,7.3
1506,2020,"Pobla de Montornès, la",56,12.29,Tarragonès,Costal,Tarragona,22,Tarragona,236,982,285,213,875,293,449,1857,578,2884,1503,1381,0.5212,0.4788,0.1557,0.6439,0.2004,234.66
1507,2020,"Pobla de Segur, la",524,32.83,Pallars Jussà,Pre-Pirineu,Tremp,14,Lleida,221,946,348,196,892,440,417,1838,788,3043,1515,1528,0.4979,0.5021,0.137,0.604,0.259,92.69
1508,2020,Poboleda,343,13.95,Priorat,Interior,Falset,23,Tarragona,18,107,41,21,90,44,39,197,85,321,166,155,0.5171,0.4829,0.1215,0.6137,0.2648,23.01
1509,2020,Polinyà,123,8.79,Vallès Occidental,Interior,Sabadell i Terrassa,23,Barcelona,865,3018,437,848,2832,504,1713,5850,941,8504,4320,4184,0.508,0.492,0.2014,0.6879,0.1107,967.46
1510,2020,"Pont d'Armentera, el",349,21.67,Alt Camp,Interior,Valls,23,Tarragona,24,156,69,25,135,79,49,291,148,488,249,239,0.5102,0.4898,0.1004,0.5963,0.3033,22.52
1511,2020,"Pont de Bar, el",861,42.62,Alt Urgell,Pirineu,"Seu d'Urgell, la",19,Lleida,18,55,18,0,39,22,18,94,40,152,91,61,0.5987,0.4013,0.1184,0.6184,0.2632,3.57
1512,2020,Pont de Molins,43,8.66,Alt Empordà,Costal,Figueres,68,Girona,31,174,56,34,167,54,65,341,110,516,261,255,0.5058,0.4942,0.126,0.6609,0.2132,59.58
1513,2020,"Pont de Suert, el",838,148.14,Alta Ribagorça,Pirineu,"Pont de Suert, el",3,Lleida,171,752,205,158,704,267,329,1456,472,2257,1128,1129,0.4998,0.5002,0.1458,0.6451,0.2091,15.24
1514,2020,"Pont de Vilomara i Rocafort, el",202,27.41,Bages,Interior,Manresa,30,Barcelona,338,1350,319,283,1243,374,621,2593,693,3907,2007,1900,0.5137,0.4863,0.1589,0.6637,0.1774,142.54
1515,2020,Pontils,551,67.56,Conca de Barberà,Interior,Montblanc,22,Tarragona,3,37,26,6,35,15,9,72,41,122,66,56,0.541,0.459,0.0738,0.5902,0.3361,1.81
1516,2020,Pontons,584,25.94,Alt Penedès,Interior,Vilafranca del Penedès,27,Barcelona,40,191,52,25,172,48,65,363,100,528,283,245,0.536,0.464,0.1231,0.6875,0.1894,20.35
1517,2020,Pontós,94,13.66,Alt Empordà,Costal,Figueres,68,Girona,23,92,26,18,72,29,41,164,55,260,141,119,0.5423,0.4577,0.1577,0.6308,0.2115,19.03
1518,2020,Ponts,363,30.52,Noguera,Interior,Balaguer,30,Lleida,193,895,249,177,810,320,370,1705,569,2644,1337,1307,0.5057,0.4943,0.1399,0.6449,0.2152,86.63
1519,2020,Porqueres,148,33.52,Pla de l'Estany,Interior,Banyoles,11,Girona,375,1544,385,384,1527,462,759,3071,847,4677,2304,2373,0.4926,0.5074,0.1623,0.6566,0.1811,139.53
1520,2020,Porrera,316,28.83,Priorat,Interior,Falset,23,Tarragona,17,166,40,22,121,58,39,287,98,424,223,201,0.5259,0.4741,0.092,0.6769,0.2311,14.71
1521,2020,"Port de la Selva, el",12,41.62,Alt Empordà,Costal,Figueres,68,Girona,66,302,129,48,277,136,114,579,265,958,497,461,0.5188,0.4812,0.119,0.6044,0.2766,23.02
1522,2020,Portbou,28,9.22,Alt Empordà,Costal,Figueres,68,Girona,33,319,169,49,289,204,82,608,373,1063,521,542,0.4901,0.5099,0.0771,0.572,0.3509,115.29
1523,2020,"Portella, la",259,12.31,Segrià,Costal,Lleida,38,Lleida,48,298,77,36,218,66,84,516,143,743,423,320,0.5693,0.4307,0.1131,0.6945,0.1925,60.36
1524,2020,Pradell de la Teixeta,463,21.83,Priorat,Interior,Falset,23,Tarragona,4,48,22,8,55,21,12,103,43,158,74,84,0.4684,0.5316,0.0759,0.6519,0.2722,7.24
1525,2020,Prades,950,32.58,Baix Camp,Costal,Reus,28,Tarragona,41,195,75,28,169,80,69,364,155,588,311,277,0.5289,0.4711,0.1173,0.619,0.2636,18.05
1526,2020,Prat de Comte,363,26.43,Terra Alta,Interior,Gandesa,12,Tarragona,9,64,24,6,40,34,15,104,58,177,97,80,0.548,0.452,0.0847,0.5876,0.3277,6.7
1527,2020,"Prat de Llobregat, el",8,31.41,Baix Llobregat,Costal,St. Feliu de Llobregat,30,Barcelona,5079,21398,5474,4933,21302,7199,10012,42700,12673,65385,31951,33434,0.4887,0.5113,0.1531,0.6531,0.1938,2081.66
1528,2020,Pratdip,245,36.27,Baix Camp,Costal,Reus,28,Tarragona,38,233,117,40,181,117,78,414,234,726,388,338,0.5344,0.4656,0.1074,0.5702,0.3223,20.02
1529,2020,Prats de Lluçanès,707,13.78,Osona,Interior,Vic,50,Barcelona,170,860,275,168,807,324,338,1667,599,2604,1305,1299,0.5012,0.4988,0.1298,0.6402,0.23,188.97
1530,2020,"Prats de Rei, els",608,26.06,Anoia,Interior,Igualada,33,Barcelona,44,192,50,31,148,72,75,340,122,537,286,251,0.5326,0.4674,0.1397,0.6331,0.2272,20.61
1531,2020,Prats i Sansor,1124,6.57,Cerdanya,Pirineu,Puigcerdà,17,Girona,9,85,22,12,67,27,21,152,49,222,116,106,0.5225,0.4775,0.0946,0.6847,0.2207,33.79
1532,2020,Preixana,328,21.52,Urgell,Interior,Tàrrega,20,Lleida,23,121,56,25,101,61,48,222,117,387,200,187,0.5168,0.4832,0.124,0.5736,0.3023,17.98
1533,2020,Preixens,315,28.67,Noguera,Interior,Balaguer,30,Lleida,24,120,67,28,102,77,52,222,144,418,211,207,0.5048,0.4952,0.1244,0.5311,0.3445,14.58
1534,2020,Premià de Dalt,142,6.57,Maresme,Costal,Mataró,30,Barcelona,876,3425,900,810,3420,1010,1686,6845,1910,10441,5201,5240,0.4981,0.5019,0.1615,0.6556,0.1829,1589.19
1535,2020,Premià de Mar,8,2.11,Maresme,Costal,Mataró,30,Barcelona,2152,9379,2382,2021,9240,3357,4173,18619,5739,28531,13913,14618,0.4876,0.5124,0.1463,0.6526,0.2011,13521.8
1536,2020,"Preses, les",474,9.39,Garrotxa,Pre-Pirineu,Olot,21,Girona,160,613,148,161,587,186,321,1200,334,1855,921,934,0.4965,0.5035,0.173,0.6469,0.1801,197.55
1537,2020,Prullans,1096,21.21,Cerdanya,Pirineu,Puigcerdà,17,Girona,16,61,27,14,83,25,30,144,52,226,104,122,0.4602,0.5398,0.1327,0.6372,0.2301,10.66
1538,2020,Puigcerdà,1202,18.92,Cerdanya,Pirineu,Puigcerdà,17,Girona,709,3372,631,690,3235,849,1399,6607,1480,9486,4712,4774,0.4967,0.5033,0.1475,0.6965,0.156,501.37
1539,2020,Puigdàlber,239,0.4,Alt Penedès,Interior,Vilafranca del Penedès,27,Barcelona,37,173,39,64,161,50,101,334,89,524,249,275,0.4752,0.5248,0.1927,0.6374,0.1698,1310.0
1540,2020,Puiggròs,334,9.9,Garrigues,Interior,"Borges Blanques, les",24,Lleida,17,98,27,14,77,45,31,175,72,278,142,136,0.5108,0.4892,0.1115,0.6295,0.259,28.08
1541,2020,Puigpelat,252,9.48,Alt Camp,Interior,Valls,23,Tarragona,113,432,59,101,389,69,214,821,128,1163,604,559,0.5193,0.4807,0.184,0.7059,0.1101,122.68
1542,2020,Puig-reig,455,45.75,Berguedà,Pre-Pirineu,Berga,31,Barcelona,271,1393,471,259,1278,623,530,2671,1094,4295,2135,2160,0.4971,0.5029,0.1234,0.6219,0.2547,93.88
1543,2020,Puigverd d'Agramunt,366,17.0,Urgell,Interior,Tàrrega,20,Lleida,9,90,32,8,61,29,17,151,61,229,131,98,0.5721,0.4279,0.0742,0.6594,0.2664,13.47
1544,2020,Puigverd de Lleida,219,12.51,Segrià,Costal,Lleida,38,Lleida,99,480,115,99,404,152,198,884,267,1349,694,655,0.5145,0.4855,0.1468,0.6553,0.1979,107.83
1545,2020,Pujalt,770,31.43,Anoia,Interior,Igualada,33,Barcelona,22,68,28,12,55,25,34,123,53,210,118,92,0.5619,0.4381,0.1619,0.5857,0.2524,6.68
1546,2020,"Quar, la",885,38.25,Berguedà,Pre-Pirineu,Berga,31,Barcelona,6,11,9,3,14,6,9,25,15,49,26,23,0.5306,0.4694,0.1837,0.5102,0.3061,1.28
1547,2020,Quart,91,38.09,Gironès,Interior,Girona,27,Girona,416,1248,246,395,1211,282,811,2459,528,3798,1910,1888,0.5029,0.4971,0.2135,0.6474,0.139,99.71
1548,2020,Queralbs,1236,93.47,Ripollès,Pirineu,Ripoll,19,Girona,6,67,25,4,61,25,10,128,50,188,98,90,0.5213,0.4787,0.0532,0.6809,0.266,2.01
1549,2020,Querol,565,72.26,Alt Camp,Interior,Valls,23,Tarragona,34,178,73,29,150,54,63,328,127,518,285,233,0.5502,0.4498,0.1216,0.6332,0.2452,7.17
1550,2020,Rabós,106,45.1,Alt Empordà,Costal,Figueres,68,Girona,12,58,22,11,53,28,23,111,50,184,92,92,0.5,0.5,0.125,0.6033,0.2717,4.08
1551,2020,Rajadell,361,45.53,Bages,Interior,Manresa,30,Barcelona,30,181,62,39,166,56,69,347,118,534,273,261,0.5112,0.4888,0.1292,0.6498,0.221,11.73
1552,2020,Rasquera,174,51.31,Ribera d'Ebre,Interior,Móra d'Ebre,14,Tarragona,47,228,113,40,217,138,87,445,251,783,388,395,0.4955,0.5045,0.1111,0.5683,0.3206,15.26
1553,2020,Regencós,78,6.27,Baix Empordà,Costal,"Bisbal d'Empordà, la",36,Girona,17,98,35,16,77,33,33,175,68,276,150,126,0.5435,0.4565,0.1196,0.6341,0.2464,44.02
1554,2020,Rellinars,322,17.79,Vallès Occidental,Interior,Sabadell i Terrassa,23,Barcelona,54,296,67,78,253,61,132,549,128,809,417,392,0.5155,0.4845,0.1632,0.6786,0.1582,45.47
1555,2020,Renau,175,8.22,Tarragonès,Costal,Tarragona,22,Tarragona,19,60,6,15,56,6,34,116,12,162,85,77,0.5247,0.4753,0.2099,0.716,0.0741,19.71
1556,2020,Reus,117,52.82,Baix Camp,Costal,Reus,28,Tarragona,9129,34045,8161,8666,35200,10967,17795,69245,19128,106168,51335,54833,0.4835,0.5165,0.1676,0.6522,0.1802,2010.0
1557,2020,Rialp,725,63.3,Pallars Sobirà,Pirineu,Sort,15,Lleida,40,232,47,32,227,63,72,459,110,641,319,322,0.4977,0.5023,0.1123,0.7161,0.1716,10.13
1558,2020,"Riba, la",263,7.99,Alt Camp,Interior,Valls,23,Tarragona,35,204,80,25,155,86,60,359,166,585,319,266,0.5453,0.4547,0.1026,0.6137,0.2838,73.22
1559,2020,Riba-roja d'Ebre,76,99.14,Ribera d'Ebre,Interior,Móra d'Ebre,14,Tarragona,52,374,157,56,286,185,108,660,342,1110,583,527,0.5252,0.4748,0.0973,0.5946,0.3081,11.2
1560,2020,Ribera d'Ondara,570,54.47,Segarra,Interior,Cervera,21,Lleida,24,136,55,25,126,67,49,262,122,433,215,218,0.4965,0.5035,0.1132,0.6051,0.2818,7.95
1561,2020,Ribera d'Urgellet,702,106.96,Alt Urgell,Pirineu,"Seu d'Urgell, la",19,Lleida,70,327,83,65,287,100,135,614,183,932,480,452,0.515,0.485,0.1448,0.6588,0.1964,8.71
1562,2020,Ribes de Freser,912,41.87,Ripollès,Pirineu,Ripoll,19,Girona,96,572,215,76,524,277,172,1096,492,1760,883,877,0.5017,0.4983,0.0977,0.6227,0.2795,42.03
1563,2020,Riells i Viabrea,96,26.98,Selva,Costal,Sta. Coloma de Farners,26,Girona,317,1477,316,269,1446,328,586,2923,644,4153,2110,2043,0.5081,0.4919,0.1411,0.7038,0.1551,153.93
1564,2020,"Riera de Gaià, la",28,8.76,Tarragonès,Costal,Tarragona,22,Tarragona,181,570,123,171,550,147,352,1120,270,1742,874,868,0.5017,0.4983,0.2021,0.6429,0.155,198.86
1565,2020,Riner,830,47.1,Solsonès,Pre-Pirineu,Solsona,15,Lleida,20,82,31,21,71,38,41,153,69,263,133,130,0.5057,0.4943,0.1559,0.5817,0.2624,5.58
1566,2020,Ripoll,691,73.71,Ripollès,Pirineu,Ripoll,19,Girona,779,3505,1085,707,3308,1419,1486,6813,2504,10803,5369,5434,0.497,0.503,0.1376,0.6307,0.2318,146.56
1567,2020,Ripollet,79,4.33,Vallès Occidental,Interior,Sabadell i Terrassa,23,Barcelona,3510,13291,2595,3308,13071,3404,6818,26362,5999,39179,19396,19783,0.4951,0.5049,0.174,0.6729,0.1531,9048.27
1568,2020,Riu de Cerdanya,1173,12.34,Cerdanya,Pirineu,Puigcerdà,17,Girona,4,37,14,1,30,7,5,67,21,93,55,38,0.5914,0.4086,0.0538,0.7204,0.2258,7.54
1569,2020,Riudarenes,84,47.6,Selva,Costal,Sta. Coloma de Farners,26,Girona,177,757,200,170,694,206,347,1451,406,2204,1134,1070,0.5145,0.4855,0.1574,0.6583,0.1842,46.3
1570,2020,Riudaura,572,23.6,Garrotxa,Pre-Pirineu,Olot,21,Girona,37,153,40,52,154,45,89,307,85,481,230,251,0.4782,0.5218,0.185,0.6383,0.1767,20.38
1571,2020,Riudecanyes,195,17.1,Baix Camp,Costal,Reus,28,Tarragona,99,411,101,80,346,109,179,757,210,1146,611,535,0.5332,0.4668,0.1562,0.6606,0.1832,67.02
1572,2020,Riudecols,299,19.46,Baix Camp,Costal,Reus,28,Tarragona,74,437,106,76,370,126,150,807,232,1189,617,572,0.5189,0.4811,0.1262,0.6787,0.1951,61.1
1573,2020,Riudellots de la Selva,98,13.12,Selva,Costal,Sta. Coloma de Farners,26,Girona,181,709,165,154,673,189,335,1382,354,2071,1055,1016,0.5094,0.4906,0.1618,0.6673,0.1709,157.85
1574,2020,Riudoms,125,32.43,Baix Camp,Costal,Reus,28,Tarragona,594,2164,594,495,2016,706,1089,4180,1300,6569,3352,3217,0.5103,0.4897,0.1658,0.6363,0.1979,202.56
1575,2020,Riumors,7,6.54,Alt Empordà,Costal,Figueres,68,Girona,16,77,28,16,75,34,32,152,62,246,121,125,0.4919,0.5081,0.1301,0.6179,0.252,37.61
1576,2020,"Roca del Vallès, la",123,36.9,Vallès Oriental,Interior,Granollers,39,Barcelona,905,3686,765,897,3572,929,1802,7258,1694,10754,5356,5398,0.498,0.502,0.1676,0.6749,0.1575,291.44
1577,2020,Rocafort de Queralt,566,8.47,Conca de Barberà,Interior,Montblanc,22,Tarragona,12,68,34,10,51,36,22,119,70,211,114,97,0.5403,0.4597,0.1043,0.564,0.3318,24.91
1578,2020,Roda de Berà,57,16.5,Tarragonès,Costal,Tarragona,22,Tarragona,528,2253,682,493,2056,773,1021,4309,1455,6785,3463,3322,0.5104,0.4896,0.1505,0.6351,0.2144,411.21
1579,2020,Roda de Ter,443,2.23,Osona,Interior,Vic,50,Barcelona,544,2206,485,513,2092,650,1057,4298,1135,6490,3235,3255,0.4985,0.5015,0.1629,0.6622,0.1749,2910.31
1580,2020,Rodonyà,312,8.49,Alt Camp,Interior,Valls,23,Tarragona,41,183,41,22,150,57,63,333,98,494,265,229,0.5364,0.4636,0.1275,0.6741,0.1984,58.19
1581,2020,Roquetes,14,136.92,Baix Ebre,Costal,Tortosa,14,Tarragona,665,2849,656,621,2498,790,1286,5347,1446,8079,4170,3909,0.5162,0.4838,0.1592,0.6618,0.179,59.01
1582,2020,Roses,5,45.91,Alt Empordà,Costal,Figueres,68,Girona,1613,6766,1637,1513,6336,1942,3126,13102,3579,19807,10016,9791,0.5057,0.4943,0.1578,0.6615,0.1807,431.43
1583,2020,Rosselló,252,9.92,Segrià,Costal,Lleida,38,Lleida,273,1188,202,273,1031,270,546,2219,472,3237,1663,1574,0.5137,0.4863,0.1687,0.6855,0.1458,326.31
1584,2020,"Rourell, el",114,2.32,Alt Camp,Interior,Valls,23,Tarragona,33,129,31,24,121,34,57,250,65,372,193,179,0.5188,0.4812,0.1532,0.672,0.1747,160.34
1585,2020,Rubí,123,32.3,Vallès Occidental,Interior,Sabadell i Terrassa,23,Barcelona,6696,26803,5390,6348,26398,6956,13044,53201,12346,78591,38889,39702,0.4948,0.5052,0.166,0.6769,0.1571,2433.16
1586,2020,Rubió,629,48.0,Anoia,Interior,Igualada,33,Barcelona,19,81,34,11,67,27,30,148,61,239,134,105,0.5607,0.4393,0.1255,0.6192,0.2552,4.98
1587,2020,Rupià,66,5.29,Baix Empordà,Costal,"Bisbal d'Empordà, la",36,Girona,18,84,38,26,75,32,44,159,70,273,140,133,0.5128,0.4872,0.1612,0.5824,0.2564,51.61
1588,2020,Rupit i Pruit,822,47.81,Osona,Interior,Vic,50,Barcelona,9,82,41,15,74,50,24,156,91,271,132,139,0.4871,0.5129,0.0886,0.5756,0.3358,5.67
1589,2020,Sabadell,190,37.79,Vallès Occidental,Interior,Sabadell i Terrassa,23,Barcelona,17615,70848,16925,16506,71070,23556,34121,141918,40481,216520,105388,111132,0.4867,0.5133,0.1576,0.6554,0.187,5729.56
1590,2020,Sagàs,738,44.6,Berguedà,Pre-Pirineu,Berga,31,Barcelona,15,51,11,8,46,14,23,97,25,145,77,68,0.531,0.469,0.1586,0.669,0.1724,3.25
1591,2020,Salàs de Pallars,573,20.27,Pallars Jussà,Pre-Pirineu,Tremp,14,Lleida,18,105,51,18,91,44,36,196,95,327,174,153,0.5321,0.4679,0.1101,0.5994,0.2905,16.13
1592,2020,Saldes,1215,66.4,Berguedà,Pre-Pirineu,Berga,31,Barcelona,4,102,53,10,69,40,14,171,93,278,159,119,0.5719,0.4281,0.0504,0.6151,0.3345,4.19
1593,2020,Sales de Llierca,260,35.82,Garrotxa,Pre-Pirineu,Olot,21,Girona,10,59,13,16,53,8,26,112,21,159,82,77,0.5157,0.4843,0.1635,0.7044,0.1321,4.44
1594,2020,Sallent,278,65.22,Bages,Interior,Manresa,30,Barcelona,455,2051,754,458,2036,981,913,4087,1735,6735,3260,3475,0.484,0.516,0.1356,0.6068,0.2576,103.27
1595,2020,Salomó,165,12.21,Tarragonès,Costal,Tarragona,22,Tarragona,43,190,53,49,154,60,92,344,113,549,286,263,0.5209,0.4791,0.1676,0.6266,0.2058,44.96
1596,2020,Salou,2,15.13,Tarragonès,Costal,Tarragona,22,Tarragona,2319,10696,1721,2084,9688,2018,4403,20384,3739,28526,14736,13790,0.5166,0.4834,0.1544,0.7146,0.1311,1885.39
1597,2020,Salt,83,6.64,Gironès,Interior,Girona,27,Girona,3459,11749,1712,3115,9849,2254,6574,21598,3966,32138,16920,15218,0.5265,0.4735,0.2046,0.672,0.1234,4840.06
1598,2020,Sanaüja,409,32.99,Segarra,Interior,Cervera,21,Lleida,17,126,55,16,100,65,33,226,120,379,198,181,0.5224,0.4776,0.0871,0.5963,0.3166,11.49
1599,2020,Sant Adrià de Besòs,14,3.82,Barcelonès,Costal,Barcelona,5,Barcelona,3143,12569,2657,2940,12320,3818,6083,24889,6475,37447,18369,19078,0.4905,0.5095,0.1624,0.6646,0.1729,9802.88
1600,2020,Sant Agustí de Lluçanès,816,13.22,Osona,Interior,Vic,50,Barcelona,3,30,11,7,27,11,10,57,22,89,44,45,0.4944,0.5056,0.1124,0.6404,0.2472,6.73
1601,2020,Sant Andreu de la Barca,42,5.5,Baix Llobregat,Costal,St. Feliu de Llobregat,30,Barcelona,2497,9371,1776,2410,9086,2429,4907,18457,4205,27569,13644,13925,0.4949,0.5051,0.178,0.6695,0.1525,5012.55
1602,2020,Sant Andreu de Llavaneres,114,11.83,Maresme,Costal,Mataró,30,Barcelona,904,3717,892,825,3738,1057,1729,7455,1949,11133,5513,5620,0.4952,0.5048,0.1553,0.6696,0.1751,941.08
1603,2020,Sant Andreu Salou,132,5.96,Gironès,Interior,Girona,27,Girona,15,49,14,9,52,21,24,101,35,160,78,82,0.4875,0.5125,0.15,0.6312,0.2188,26.85
1604,2020,Sant Aniol de Finestres,289,47.73,Garrotxa,Pre-Pirineu,Olot,21,Girona,25,119,36,26,106,33,51,225,69,345,180,165,0.5217,0.4783,0.1478,0.6522,0.2,7.23
1605,2020,Sant Antoni de Vilamajor,258,13.7,Vallès Oriental,Interior,Granollers,39,Barcelona,522,2094,450,508,2113,521,1030,4207,971,6208,3066,3142,0.4939,0.5061,0.1659,0.6777,0.1564,453.14
1606,2020,Sant Bartomeu del Grau,868,34.4,Osona,Interior,Vic,50,Barcelona,78,309,88,55,265,89,133,574,177,884,475,409,0.5373,0.4627,0.1505,0.6493,0.2002,25.7
1607,2020,Sant Boi de Llobregat,30,21.47,Baix Llobregat,Costal,St. Feliu de Llobregat,30,Barcelona,6591,27739,6905,6201,27714,9350,12792,55453,16255,84500,41235,43265,0.488,0.512,0.1514,0.6562,0.1924,3935.72
1608,2020,Sant Boi de Lluçanès,813,19.53,Osona,Interior,Vic,50,Barcelona,22,178,93,36,145,106,58,323,199,580,293,287,0.5052,0.4948,0.1,0.5569,0.3431,29.7
1609,2020,Sant Carles de la Ràpita,11,53.72,Montsià,Costal,Amposta,12,Tarragona,997,4803,1516,961,4814,1862,1958,9617,3378,14953,7316,7637,0.4893,0.5107,0.1309,0.6431,0.2259,278.35
1610,2020,Sant Cebrià de Vallalta,71,15.68,Maresme,Costal,Mataró,30,Barcelona,297,1229,265,299,1091,257,596,2320,522,3438,1791,1647,0.5209,0.4791,0.1734,0.6748,0.1518,219.26
1611,2020,Sant Celoni,152,65.23,Vallès Oriental,Interior,Granollers,39,Barcelona,1543,6108,1381,1455,5812,1837,2998,11920,3218,18136,9032,9104,0.498,0.502,0.1653,0.6573,0.1774,278.03
1612,2020,Sant Climent de Llobregat,87,10.81,Baix Llobregat,Costal,St. Feliu de Llobregat,30,Barcelona,410,1409,278,368,1407,288,778,2816,566,4160,2097,2063,0.5041,0.4959,0.187,0.6769,0.1361,384.83
1613,2020,Sant Climent Sescebes,86,24.37,Alt Empordà,Costal,Figueres,68,Girona,35,353,51,50,151,67,85,504,118,707,439,268,0.6209,0.3791,0.1202,0.7129,0.1669,29.01
1614,2020,Sant Cugat del Vallès,124,48.23,Vallès Occidental,Interior,Sabadell i Terrassa,23,Barcelona,9122,30273,5821,8474,31864,7423,17596,62137,13244,92977,45216,47761,0.4863,0.5137,0.1893,0.6683,0.1424,1927.78
1615,2020,Sant Cugat Sesgarrigues,266,6.24,Alt Penedès,Interior,Vilafranca del Penedès,27,Barcelona,77,326,88,98,316,104,175,642,192,1009,491,518,0.4866,0.5134,0.1734,0.6363,0.1903,161.7
1616,2020,Sant Esteve de la Sarga,875,92.87,Pallars Jussà,Pre-Pirineu,Tremp,14,Lleida,2,45,27,4,28,16,6,73,43,122,74,48,0.6066,0.3934,0.0492,0.5984,0.3525,1.31
1617,2020,Sant Esteve de Palautordera,231,10.64,Vallès Oriental,Interior,Granollers,39,Barcelona,272,945,195,242,999,211,514,1944,406,2864,1412,1452,0.493,0.507,0.1795,0.6788,0.1418,269.17
1618,2020,Sant Esteve Sesrovires,183,18.56,Baix Llobregat,Costal,St. Feliu de Llobregat,30,Barcelona,632,2669,561,577,2577,680,1209,5246,1241,7696,3862,3834,0.5018,0.4982,0.1571,0.6817,0.1613,414.66
1619,2020,Sant Feliu de Buixalleu,402,61.94,Selva,Costal,Sta. Coloma de Farners,26,Girona,45,279,90,59,248,76,104,527,166,797,414,383,0.5194,0.4806,0.1305,0.6612,0.2083,12.87
1620,2020,Sant Feliu de Codines,480,15.0,Vallès Oriental,Interior,Granollers,39,Barcelona,532,2257,443,456,2073,602,988,4330,1045,6363,3232,3131,0.5079,0.4921,0.1553,0.6805,0.1642,424.2
1621,2020,Sant Feliu de Guíxols,4,16.23,Baix Empordà,Costal,"Bisbal d'Empordà, la",36,Girona,1705,7211,1955,1663,7079,2484,3368,14290,4439,22097,10871,11226,0.492,0.508,0.1524,0.6467,0.2009,1361.49
1622,2020,Sant Feliu de Llobregat,25,11.82,Baix Llobregat,Costal,St. Feliu de Llobregat,30,Barcelona,3551,14757,3796,3411,14965,4987,6962,29722,8783,45467,22104,23363,0.4862,0.5138,0.1531,0.6537,0.1932,3846.62
1623,2020,Sant Feliu de Pallerols,473,34.86,Garrotxa,Pre-Pirineu,Olot,21,Girona,123,458,143,96,443,174,219,901,317,1437,724,713,0.5038,0.4962,0.1524,0.627,0.2206,41.22
1624,2020,Sant Feliu Sasserra,617,22.36,Bages,Interior,Manresa,30,Barcelona,48,198,73,39,166,81,87,364,154,605,319,286,0.5273,0.4727,0.1438,0.6017,0.2545,27.06
1625,2020,Sant Ferriol,146,42.24,Garrotxa,Pre-Pirineu,Olot,21,Girona,25,74,26,22,67,22,47,141,48,236,125,111,0.5297,0.4703,0.1992,0.5975,0.2034,5.59
1626,2020,Sant Fost de Campsentelles,112,13.15,Vallès Oriental,Interior,Granollers,39,Barcelona,659,2905,844,601,2825,1019,1260,5730,1863,8853,4408,4445,0.4979,0.5021,0.1423,0.6472,0.2104,673.23
1627,2020,Sant Fruitós de Bages,247,22.2,Bages,Interior,Manresa,30,Barcelona,731,2977,640,740,2954,795,1471,5931,1435,8837,4348,4489,0.492,0.508,0.1665,0.6712,0.1624,398.06
1628,2020,Sant Gregori,112,49.17,Gironès,Interior,Girona,27,Girona,396,1311,310,335,1247,329,731,2558,639,3928,2017,1911,0.5135,0.4865,0.1861,0.6512,0.1627,79.89
1629,2020,Sant Guim de Freixenet,738,25.1,Segarra,Interior,Cervera,21,Lleida,73,348,118,74,282,142,147,630,260,1037,539,498,0.5198,0.4802,0.1418,0.6075,0.2507,41.31
1630,2020,Sant Guim de la Plana,556,12.45,Segarra,Interior,Cervera,21,Lleida,10,64,25,5,48,29,15,112,54,181,99,82,0.547,0.453,0.0829,0.6188,0.2983,14.54
1631,2020,Sant Hilari Sacalm,803,83.28,Selva,Costal,Sta. Coloma de Farners,26,Girona,432,1894,558,448,1722,649,880,3616,1207,5703,2884,2819,0.5057,0.4943,0.1543,0.6341,0.2116,68.48
1632,2020,Sant Hipòlit de Voltregà,536,0.92,Osona,Interior,Vic,50,Barcelona,284,1200,281,246,1129,400,530,2329,681,3540,1765,1775,0.4986,0.5014,0.1497,0.6579,0.1924,3847.83
1633,2020,Sant Iscle de Vallalta,129,17.77,Maresme,Costal,Mataró,30,Barcelona,125,492,95,109,421,100,234,913,195,1342,712,630,0.5306,0.4694,0.1744,0.6803,0.1453,75.52
1634,2020,Sant Jaume d'Enveja,7,60.79,Montsià,Costal,Amposta,12,Tarragona,216,1169,396,242,1054,450,458,2223,846,3527,1781,1746,0.505,0.495,0.1299,0.6303,0.2399,58.02
1635,2020,Sant Jaume de Frontanyà,1072,21.26,Berguedà,Pre-Pirineu,Berga,31,Barcelona,2,8,8,1,7,4,3,15,12,30,18,12,0.6,0.4,0.1,0.5,0.4,1.41
1636,2020,Sant Jaume de Llierca,203,6.75,Garrotxa,Pre-Pirineu,Olot,21,Girona,67,260,93,66,269,116,133,529,209,871,420,451,0.4822,0.5178,0.1527,0.6073,0.24,129.04
1637,2020,Sant Jaume dels Domenys,213,24.45,Baix Penedès,Costal,"Vendrell, el",14,Tarragona,259,880,209,242,797,237,501,1677,446,2624,1348,1276,0.5137,0.4863,0.1909,0.6391,0.17,107.32
1638,2020,Sant Joan de les Abadesses,773,53.67,Ripollès,Pirineu,Ripoll,19,Girona,208,988,399,189,926,514,397,1914,913,3224,1595,1629,0.4947,0.5053,0.1231,0.5937,0.2832,60.07
1639,2020,Sant Joan de Mollet,54,3.15,Gironès,Interior,Girona,27,Girona,35,161,45,45,160,52,80,321,97,498,241,257,0.4839,0.5161,0.1606,0.6446,0.1948,158.1
1640,2020,Sant Joan de Vilatorrada,277,16.42,Bages,Interior,Manresa,30,Barcelona,897,3676,948,833,3476,1168,1730,7152,2116,10998,5521,5477,0.502,0.498,0.1573,0.6503,0.1924,669.79
1641,2020,Sant Joan Despí,10,6.17,Baix Llobregat,Costal,St. Feliu de Llobregat,30,Barcelona,2851,11208,2633,2648,11527,3400,5499,22735,6033,34267,16692,17575,0.4871,0.5129,0.1605,0.6635,0.1761,5553.81
1642,2020,Sant Joan les Fonts,342,31.94,Garrotxa,Pre-Pirineu,Olot,21,Girona,239,988,326,202,899,390,441,1887,716,3044,1553,1491,0.5102,0.4898,0.1449,0.6199,0.2352,95.3
1643,2020,Sant Jordi Desvalls,57,11.72,Gironès,Interior,Girona,27,Girona,64,238,75,62,240,81,126,478,156,760,377,383,0.4961,0.5039,0.1658,0.6289,0.2053,64.85
1644,2020,Sant Julià de Cerdanyola,954,11.79,Berguedà,Pre-Pirineu,Berga,31,Barcelona,15,85,27,8,66,28,23,151,55,229,127,102,0.5546,0.4454,0.1004,0.6594,0.2402,19.42
1645,2020,Sant Julià de Ramis,128,18.8,Gironès,Interior,Girona,27,Girona,344,1233,237,326,1187,249,670,2420,486,3576,1814,1762,0.5073,0.4927,0.1874,0.6767,0.1359,190.21
1646,2020,Sant Julià de Vilatorta,600,15.94,Osona,Interior,Vic,50,Barcelona,260,1050,249,253,1028,300,513,2078,549,3140,1559,1581,0.4965,0.5035,0.1634,0.6618,0.1748,196.99
1647,2020,Sant Julià del Llor i Bonmatí,160,9.73,Selva,Costal,Sta. Coloma de Farners,26,Girona,107,456,97,113,434,106,220,890,203,1313,660,653,0.5027,0.4973,0.1676,0.6778,0.1546,134.94
1648,2020,Sant Just Desvern,122,7.81,Baix Llobregat,Costal,St. Feliu de Llobregat,30,Barcelona,1656,5789,1506,1604,6096,2019,3260,11885,3525,18670,8951,9719,0.4794,0.5206,0.1746,0.6366,0.1888,2390.52
1649,2020,Sant Llorenç d'Hortons,196,19.72,Alt Penedès,Interior,Vilafranca del Penedès,27,Barcelona,196,846,192,203,799,192,399,1645,384,2428,1234,1194,0.5082,0.4918,0.1643,0.6775,0.1582,123.12
1650,2020,Sant Llorenç de la Muga,173,31.84,Alt Empordà,Costal,Figueres,68,Girona,15,94,25,18,78,35,33,172,60,265,134,131,0.5057,0.4943,0.1245,0.6491,0.2264,8.32
1651,2020,Sant Llorenç de Morunys,925,4.34,Solsonès,Pre-Pirineu,Solsona,15,Lleida,56,286,125,59,281,153,115,567,278,960,467,493,0.4865,0.5135,0.1198,0.5906,0.2896,221.2
1652,2020,Sant Llorenç Savall,466,41.11,Vallès Occidental,Interior,Sabadell i Terrassa,23,Barcelona,168,794,254,166,743,292,334,1537,546,2417,1216,1201,0.5031,0.4969,0.1382,0.6359,0.2259,58.79
1653,2020,Sant Martí d'Albars,629,14.73,Osona,Interior,Vic,50,Barcelona,8,33,16,9,32,16,17,65,32,114,57,57,0.5,0.5,0.1491,0.5702,0.2807,7.74
1654,2020,Sant Martí de Centelles,404,25.55,Osona,Interior,Vic,50,Barcelona,82,453,74,87,379,109,169,832,183,1184,609,575,0.5144,0.4856,0.1427,0.7027,0.1546,46.34
1655,2020,Sant Martí de Llémena,256,43.13,Gironès,Interior,Girona,27,Girona,57,224,53,50,219,38,107,443,91,641,334,307,0.5211,0.4789,0.1669,0.6911,0.142,14.86
1656,2020,Sant Martí de Riucorb,409,34.9,Urgell,Interior,Tàrrega,20,Lleida,31,201,96,42,152,117,73,353,213,639,328,311,0.5133,0.4867,0.1142,0.5524,0.3333,18.31
1657,2020,Sant Martí de Tous,465,39.21,Anoia,Interior,Igualada,33,Barcelona,115,409,110,113,356,125,228,765,235,1228,634,594,0.5163,0.4837,0.1857,0.623,0.1914,31.32
1658,2020,Sant Martí Sarroca,291,35.27,Alt Penedès,Interior,Vilafranca del Penedès,27,Barcelona,256,1069,280,271,1063,322,527,2132,602,3261,1605,1656,0.4922,0.5078,0.1616,0.6538,0.1846,92.46
1659,2020,Sant Martí Sesgueioles,646,3.87,Anoia,Interior,Igualada,33,Barcelona,25,122,31,14,109,41,39,231,72,342,178,164,0.5205,0.4795,0.114,0.6754,0.2105,88.37
1660,2020,Sant Martí Vell,65,17.52,Gironès,Interior,Girona,27,Girona,13,101,22,16,70,29,29,171,51,251,136,115,0.5418,0.4582,0.1155,0.6813,0.2032,14.33
1661,2020,Sant Mateu de Bages,569,102.92,Bages,Interior,Manresa,30,Barcelona,38,189,86,29,159,107,67,348,193,608,313,295,0.5148,0.4852,0.1102,0.5724,0.3174,5.91
1662,2020,Sant Miquel de Campmajor,217,33.22,Pla de l'Estany,Interior,Banyoles,11,Girona,22,84,21,19,61,22,41,145,43,229,127,102,0.5546,0.4454,0.179,0.6332,0.1878,6.89
1663,2020,Sant Miquel de Fluvià,28,3.51,Alt Empordà,Costal,Figueres,68,Girona,62,261,73,59,235,71,121,496,144,761,396,365,0.5204,0.4796,0.159,0.6518,0.1892,216.81
1664,2020,Sant Mori,51,7.53,Alt Empordà,Costal,Figueres,68,Girona,11,55,18,11,52,19,22,107,37,166,84,82,0.506,0.494,0.1325,0.6446,0.2229,22.05
1665,2020,Sant Pau de Segúries,867,8.74,Ripollès,Pirineu,Ripoll,19,Girona,50,205,89,41,202,101,91,407,190,688,344,344,0.5,0.5,0.1323,0.5916,0.2762,78.72
1666,2020,Sant Pere de Ribes,44,40.8,Garraf,Costal,Vilanova i la Geltrú,6,Barcelona,2548,10727,2181,2525,10490,2640,5073,21217,4821,31111,15456,15655,0.4968,0.5032,0.1631,0.682,0.155,762.52
1667,2020,Sant Pere de Riudebitlles,246,5.38,Alt Penedès,Interior,Vilafranca del Penedès,27,Barcelona,218,746,227,180,716,293,398,1462,520,2380,1191,1189,0.5004,0.4996,0.1672,0.6143,0.2185,442.38
1668,2020,Sant Pere de Torelló,621,55.13,Osona,Interior,Vic,50,Barcelona,200,834,242,150,752,292,350,1586,534,2470,1276,1194,0.5166,0.4834,0.1417,0.6421,0.2162,44.8
1669,2020,Sant Pere de Vilamajor,305,34.72,Vallès Oriental,Interior,Granollers,39,Barcelona,369,1588,322,374,1522,369,743,3110,691,4544,2279,2265,0.5015,0.4985,0.1635,0.6844,0.1521,130.88
1670,2020,Sant Pere Pescador,5,18.45,Alt Empordà,Costal,Figueres,68,Girona,173,787,152,183,610,185,356,1397,337,2090,1112,978,0.5321,0.4679,0.1703,0.6684,0.1612,113.28
1671,2020,Sant Pere Sallavinera,588,22.02,Anoia,Interior,Igualada,33,Barcelona,16,46,21,8,36,24,24,82,45,151,83,68,0.5497,0.4503,0.1589,0.543,0.298,6.86
1672,2020,Sant Pol de Mar,15,7.53,Maresme,Costal,Mataró,30,Barcelona,404,1739,547,389,1727,622,793,3466,1169,5428,2690,2738,0.4956,0.5044,0.1461,0.6385,0.2154,720.85
1673,2020,Sant Quintí de Mediona,326,13.84,Alt Penedès,Interior,Vilafranca del Penedès,27,Barcelona,206,796,190,180,717,228,386,1513,418,2317,1192,1125,0.5145,0.4855,0.1666,0.653,0.1804,167.41
1674,2020,Sant Quirze de Besora,587,8.1,Osona,Interior,Vic,50,Barcelona,138,660,243,148,644,321,286,1304,564,2154,1041,1113,0.4833,0.5167,0.1328,0.6054,0.2618,265.93
1675,2020,Sant Quirze del Vallès,188,14.07,Vallès Occidental,Interior,Sabadell i Terrassa,23,Barcelona,1845,6698,1358,1778,6929,1587,3623,13627,2945,20195,9901,10294,0.4903,0.5097,0.1794,0.6748,0.1458,1435.32
1676,2020,Sant Quirze Safaja,627,26.21,Moianès,Interior,Moià,10,Barcelona,58,246,42,62,188,35,120,434,77,631,346,285,0.5483,0.4517,0.1902,0.6878,0.122,24.07
1677,2020,Sant Ramon,641,18.53,Segarra,Interior,Cervera,21,Lleida,21,155,83,28,119,81,49,274,164,487,259,228,0.5318,0.4682,0.1006,0.5626,0.3368,26.28
1678,2020,Sant Sadurní d'Anoia,162,18.96,Alt Penedès,Interior,Vilafranca del Penedès,27,Barcelona,1115,4227,986,1022,4260,1231,2137,8487,2217,12841,6328,6513,0.4928,0.5072,0.1664,0.6609,0.1727,677.27
1679,2020,Sant Sadurní d'Osormort,531,30.6,Osona,Interior,Vic,50,Barcelona,3,35,8,2,20,8,5,55,16,76,46,30,0.6053,0.3947,0.0658,0.7237,0.2105,2.48
1680,2020,Sant Salvador de Guardiola,334,37.15,Bages,Interior,Manresa,30,Barcelona,253,1133,273,239,1013,310,492,2146,583,3221,1659,1562,0.5151,0.4849,0.1527,0.6663,0.181,86.7
1681,2020,Sant Vicenç de Castellet,176,17.13,Bages,Interior,Manresa,30,Barcelona,839,3269,784,729,3067,1079,1568,6336,1863,9767,4892,4875,0.5009,0.4991,0.1605,0.6487,0.1907,570.17
1682,2020,Sant Vicenç de Montalt,143,8.05,Maresme,Costal,Mataró,30,Barcelona,543,2148,554,476,2133,598,1019,4281,1152,6452,3245,3207,0.5029,0.4971,0.1579,0.6635,0.1785,801.49
1683,2020,Sant Vicenç de Torelló,555,6.56,Osona,Interior,Vic,50,Barcelona,176,686,161,144,679,212,320,1365,373,2058,1023,1035,0.4971,0.5029,0.1555,0.6633,0.1812,313.72
1684,2020,Sant Vicenç dels Horts,22,9.12,Baix Llobregat,Costal,St. Feliu de Llobregat,30,Barcelona,2229,9737,2078,2125,9413,2686,4354,19150,4764,28268,14044,14224,0.4968,0.5032,0.154,0.6774,0.1685,3099.56
1685,2020,Santa Bàrbara,79,28.15,Montsià,Costal,Amposta,12,Tarragona,279,1221,386,270,1118,441,549,2339,827,3715,1886,1829,0.5077,0.4923,0.1478,0.6296,0.2226,131.97
1686,2020,Santa Cecília de Voltregà,519,8.63,Osona,Interior,Vic,50,Barcelona,13,68,19,12,55,15,25,123,34,182,100,82,0.5495,0.4505,0.1374,0.6758,0.1868,21.09
1687,2020,Santa Coloma de Cervelló,73,7.49,Baix Llobregat,Costal,St. Feliu de Llobregat,30,Barcelona,740,2775,522,800,2780,651,1540,5555,1173,8268,4037,4231,0.4883,0.5117,0.1863,0.6719,0.1419,1103.87
1688,2020,Santa Coloma de Farners,142,70.64,Selva,Costal,Sta. Coloma de Farners,26,Girona,1139,4605,1018,1134,4233,1234,2273,8838,2252,13363,6762,6601,0.506,0.494,0.1701,0.6614,0.1685,189.17
1689,2020,Santa Coloma de Gramenet,56,7.0,Barcelonès,Costal,Barcelona,5,Barcelona,9443,40141,9943,8904,38406,13606,18347,78547,23549,120443,59527,60916,0.4942,0.5058,0.1523,0.6522,0.1955,17206.14
1690,2020,Santa Coloma de Queralt,674,33.85,Conca de Barberà,Interior,Montblanc,22,Tarragona,201,861,279,168,798,365,369,1659,644,2672,1341,1331,0.5019,0.4981,0.1381,0.6209,0.241,78.94
1691,2020,Santa Cristina d'Aro,30,67.55,Baix Empordà,Costal,"Bisbal d'Empordà, la",36,Girona,432,1785,444,415,1702,509,847,3487,953,5287,2661,2626,0.5033,0.4967,0.1602,0.6595,0.1803,78.27
1692,2020,Santa Eugènia de Berga,538,7.01,Osona,Interior,Vic,50,Barcelona,180,773,208,151,749,217,331,1522,425,2278,1161,1117,0.5097,0.4903,0.1453,0.6681,0.1866,324.96
1693,2020,Santa Eulàlia de Riuprimer,568,13.82,Osona,Interior,Vic,50,Barcelona,141,462,97,142,422,119,283,884,216,1383,700,683,0.5061,0.4939,0.2046,0.6392,0.1562,100.07
1694,2020,Santa Eulàlia de Ronçana,236,14.23,Vallès Oriental,Interior,Granollers,39,Barcelona,628,2505,596,596,2419,682,1224,4924,1278,7426,3729,3697,0.5022,0.4978,0.1648,0.6631,0.1721,521.86
1695,2020,Santa Fe del Penedès,240,3.4,Alt Penedès,Interior,Vilafranca del Penedès,27,Barcelona,29,125,26,27,127,33,56,252,59,367,180,187,0.4905,0.5095,0.1526,0.6866,0.1608,107.94
1696,2020,Santa Llogaia d'Àlguema,42,1.94,Alt Empordà,Costal,Figueres,68,Girona,35,131,23,33,113,33,68,244,56,368,189,179,0.5136,0.4864,0.1848,0.663,0.1522,189.69
1697,2020,Santa Margarida de Montbui,316,27.59,Anoia,Interior,Igualada,33,Barcelona,960,3397,791,863,3202,1012,1823,6599,1803,10225,5148,5077,0.5035,0.4965,0.1783,0.6454,0.1763,370.61
1698,2020,Santa Margarida i els Monjos,161,17.16,Alt Penedès,Interior,Vilafranca del Penedès,27,Barcelona,761,2644,514,710,2435,612,1471,5079,1126,7676,3919,3757,0.5106,0.4894,0.1916,0.6617,0.1467,447.32
1699,2020,Santa Maria d'Oló,542,66.21,Moianès,Interior,Moià,10,Barcelona,78,325,115,66,303,137,144,628,252,1024,518,506,0.5059,0.4941,0.1406,0.6133,0.2461,15.47
1700,2020,Santa Maria de Besora,866,24.73,Osona,Interior,Vic,50,Barcelona,10,56,18,10,43,24,20,99,42,161,84,77,0.5217,0.4783,0.1242,0.6149,0.2609,6.51
1701,2020,Santa Maria de Martorelles,181,4.51,Vallès Oriental,Interior,Granollers,39,Barcelona,75,309,62,76,285,83,151,594,145,890,446,444,0.5011,0.4989,0.1697,0.6674,0.1629,197.34
1702,2020,Santa Maria de Merlès,532,52.08,Berguedà,Pre-Pirineu,Berga,31,Barcelona,18,60,11,23,57,15,41,117,26,184,89,95,0.4837,0.5163,0.2228,0.6359,0.1413,3.53
1703,2020,Santa Maria de Miralles,543,25.04,Anoia,Interior,Igualada,33,Barcelona,5,44,15,8,31,16,13,75,31,119,64,55,0.5378,0.4622,0.1092,0.6303,0.2605,4.75
1704,2020,Santa Maria de Palautordera,208,16.94,Vallès Oriental,Interior,Granollers,39,Barcelona,797,3357,716,724,3147,889,1521,6504,1605,9630,4870,4760,0.5057,0.4943,0.1579,0.6754,0.1667,568.48
1705,2020,Santa Oliva,101,9.65,Baix Penedès,Costal,"Vendrell, el",14,Tarragona,300,1128,286,264,1044,331,564,2172,617,3353,1714,1639,0.5112,0.4888,0.1682,0.6478,0.184,347.46
1706,2020,Santa Pau,496,49.01,Garrotxa,Pre-Pirineu,Olot,21,Girona,126,527,184,106,484,187,232,1011,371,1614,837,777,0.5186,0.4814,0.1437,0.6264,0.2299,32.93
1707,2020,Santa Perpètua de Mogoda,74,15.83,Vallès Occidental,Interior,Sabadell i Terrassa,23,Barcelona,2340,8950,1793,2121,8591,2204,4461,17541,3997,25999,13083,12916,0.5032,0.4968,0.1716,0.6747,0.1537,1642.39
1708,2020,Santa Susanna,10,12.63,Maresme,Costal,Mataró,30,Barcelona,314,1188,273,300,1160,313,614,2348,586,3548,1775,1773,0.5003,0.4997,0.1731,0.6618,0.1652,280.92
1709,2020,Santpedor,336,16.59,Bages,Interior,Manresa,30,Barcelona,731,2425,633,624,2441,750,1355,4866,1383,7604,3789,3815,0.4983,0.5017,0.1782,0.6399,0.1819,458.35
1710,2020,Sarral,467,52.39,Conca de Barberà,Interior,Montblanc,22,Tarragona,115,540,143,129,448,163,244,988,306,1538,798,740,0.5189,0.4811,0.1586,0.6424,0.199,29.36
1711,2020,Sarrià de Ter,70,4.16,Gironès,Interior,Girona,27,Girona,461,1722,384,437,1730,495,898,3452,879,5229,2567,2662,0.4909,0.5091,0.1717,0.6602,0.1681,1256.97
1712,2020,Sarroca de Bellera,1002,87.51,Pallars Jussà,Pre-Pirineu,Tremp,14,Lleida,1,45,22,5,26,17,6,71,39,116,68,48,0.5862,0.4138,0.0517,0.6121,0.3362,1.33
1713,2020,Sarroca de Lleida,201,42.18,Segrià,Costal,Lleida,38,Lleida,16,118,69,14,84,57,30,202,126,358,203,155,0.567,0.433,0.0838,0.5642,0.352,8.49
1714,2020,"Saus, Camallera i Llampaies",86,11.36,Alt Empordà,Costal,Figueres,68,Girona,63,273,90,68,254,108,131,527,198,856,426,430,0.4977,0.5023,0.153,0.6157,0.2313,75.35
1715,2020,Savallà del Comtat,825,14.8,Conca de Barberà,Interior,Montblanc,22,Tarragona,1,17,8,0,17,10,1,34,18,53,26,27,0.4906,0.5094,0.0189,0.6415,0.3396,3.58
1716,2020,"Secuita, la",169,17.77,Tarragonès,Costal,Tarragona,22,Tarragona,150,582,127,151,554,144,301,1136,271,1708,859,849,0.5029,0.4971,0.1762,0.6651,0.1587,96.12
1717,2020,"Selva de Mar, la",48,7.19,Alt Empordà,Costal,Figueres,68,Girona,9,67,29,5,58,27,14,125,56,195,105,90,0.5385,0.4615,0.0718,0.641,0.2872,27.12
1718,2020,"Selva del Camp, la",246,35.31,Baix Camp,Costal,Reus,28,Tarragona,486,1962,419,443,1867,506,929,3829,925,5683,2867,2816,0.5045,0.4955,0.1635,0.6738,0.1628,160.95
1719,2020,Senan,652,11.7,Conca de Barberà,Interior,Montblanc,22,Tarragona,3,17,10,3,8,3,6,25,13,44,30,14,0.6818,0.3182,0.1364,0.5682,0.2955,3.76
1720,2020,"Sénia, la",369,108.41,Montsià,Costal,Amposta,12,Tarragona,400,1901,538,382,1776,643,782,3677,1181,5640,2839,2801,0.5034,0.4966,0.1387,0.652,0.2094,52.02
1721,2020,Senterada,729,34.45,Pallars Jussà,Pre-Pirineu,Tremp,14,Lleida,5,66,11,7,38,12,12,104,23,139,82,57,0.5899,0.4101,0.0863,0.7482,0.1655,4.03
1722,2020,"Sentiu de Sió, la",281,29.62,Noguera,Interior,Balaguer,30,Lleida,21,136,60,23,114,60,44,250,120,414,217,197,0.5242,0.4758,0.1063,0.6039,0.2899,13.98
1723,2020,Sentmenat,207,28.8,Vallès Occidental,Interior,Sabadell i Terrassa,23,Barcelona,840,3213,628,785,3046,723,1625,6259,1351,9235,4681,4554,0.5069,0.4931,0.176,0.6777,0.1463,320.66
1724,2020,Serinyà,188,17.38,Pla de l'Estany,Interior,Banyoles,11,Girona,104,370,100,93,362,104,197,732,204,1133,574,559,0.5066,0.4934,0.1739,0.6461,0.1801,65.19
1725,2020,Seròs,103,85.75,Segrià,Costal,Lleida,38,Lleida,142,717,189,147,525,226,289,1242,415,1946,1048,898,0.5385,0.4615,0.1485,0.6382,0.2133,22.69
1726,2020,Serra de Daró,15,7.91,Baix Empordà,Costal,"Bisbal d'Empordà, la",36,Girona,21,76,24,14,62,25,35,138,49,222,121,101,0.545,0.455,0.1577,0.6216,0.2207,28.07
1727,2020,Setcases,1265,49.12,Ripollès,Pirineu,Ripoll,19,Girona,10,57,29,4,52,18,14,109,47,170,96,74,0.5647,0.4353,0.0824,0.6412,0.2765,3.46
1728,2020,"Seu d'Urgell, la",691,15.45,Alt Urgell,Pirineu,"Seu d'Urgell, la",19,Lleida,853,4053,1013,848,4101,1338,1701,8154,2351,12206,5919,6287,0.4849,0.5151,0.1394,0.668,0.1926,790.03
1729,2020,Seva,663,30.4,Osona,Interior,Vic,50,Barcelona,291,1226,289,249,1154,335,540,2380,624,3544,1806,1738,0.5096,0.4904,0.1524,0.6716,0.1761,116.58
1730,2020,Sidamon,232,8.12,Pla d'Urgell,Interior,Mollerussa,16,Lleida,69,273,55,50,230,71,119,503,126,748,397,351,0.5307,0.4693,0.1591,0.6725,0.1684,92.12
1731,2020,Sils,76,29.91,Selva,Costal,Sta. Coloma de Farners,26,Girona,559,2151,477,492,2009,531,1051,4160,1008,6219,3187,3032,0.5125,0.4875,0.169,0.6689,0.1621,207.92
1732,2020,Sitges,10,43.85,Garraf,Costal,Vilanova i la Geltrú,6,Barcelona,2140,10188,2483,1953,9726,3063,4093,19914,5546,29553,14811,14742,0.5012,0.4988,0.1385,0.6738,0.1877,673.96
1733,2020,Siurana,33,10.53,Alt Empordà,Costal,Figueres,68,Girona,8,55,19,14,52,23,22,107,42,171,82,89,0.4795,0.5205,0.1287,0.6257,0.2456,16.24
1734,2020,Sobremunt,881,13.79,Osona,Interior,Vic,50,Barcelona,1,26,7,5,30,9,6,56,16,78,34,44,0.4359,0.5641,0.0769,0.7179,0.2051,5.66
1735,2020,"Soleràs, el",381,12.23,Garrigues,Interior,"Borges Blanques, les",24,Lleida,17,112,46,21,77,59,38,189,105,332,175,157,0.5271,0.4729,0.1145,0.5693,0.3163,27.15
1736,2020,Solivella,489,21.37,Conca de Barberà,Interior,Montblanc,22,Tarragona,45,203,85,26,180,93,71,383,178,632,333,299,0.5269,0.4731,0.1123,0.606,0.2816,29.57
1737,2020,Solsona,664,17.7,Solsonès,Pre-Pirineu,Solsona,15,Lleida,740,3036,735,733,2895,998,1473,5931,1733,9137,4511,4626,0.4937,0.5063,0.1612,0.6491,0.1897,516.21
1738,2020,Sora,716,31.73,Osona,Interior,Vic,50,Barcelona,26,71,24,12,57,22,38,128,46,212,121,91,0.5708,0.4292,0.1792,0.6038,0.217,6.68
1739,2020,Soriguera,1258,106.39,Pallars Sobirà,Pirineu,Sort,15,Lleida,36,157,32,28,137,30,64,294,62,420,225,195,0.5357,0.4643,0.1524,0.7,0.1476,3.95
1740,2020,Sort,692,105.05,Pallars Sobirà,Pirineu,Sort,15,Lleida,175,705,186,150,708,230,325,1413,416,2154,1066,1088,0.4949,0.5051,0.1509,0.656,0.1931,20.5
1741,2020,Soses,118,30.16,Segrià,Costal,Lleida,38,Lleida,156,590,167,153,512,183,309,1102,350,1761,913,848,0.5185,0.4815,0.1755,0.6258,0.1988,58.39
1742,2020,Subirats,243,55.9,Alt Penedès,Interior,Vilafranca del Penedès,27,Barcelona,247,1080,292,215,957,313,462,2037,605,3104,1619,1485,0.5216,0.4784,0.1488,0.6562,0.1949,55.53
1743,2020,Sudanell,152,8.69,Segrià,Costal,Lleida,38,Lleida,48,307,102,40,238,105,88,545,207,840,457,383,0.544,0.456,0.1048,0.6488,0.2464,96.66
1744,2020,Sunyer,211,12.66,Segrià,Costal,Lleida,38,Lleida,19,150,31,18,88,37,37,238,68,343,200,143,0.5831,0.4169,0.1079,0.6939,0.1983,27.09
1745,2020,Súria,326,23.6,Bages,Interior,Manresa,30,Barcelona,397,1926,571,382,1871,801,779,3797,1372,5948,2894,3054,0.4866,0.5134,0.131,0.6384,0.2307,252.03
1746,2020,Susqueda,816,50.61,Selva,Costal,Sta. Coloma de Farners,26,Girona,2,41,12,5,25,8,7,66,20,93,55,38,0.5914,0.4086,0.0753,0.7097,0.2151,1.84
1747,2020,Tagamanent,354,43.31,Vallès Oriental,Interior,Granollers,39,Barcelona,24,114,23,18,114,25,42,228,48,318,161,157,0.5063,0.4937,0.1321,0.717,0.1509,7.34
1748,2020,Talamanca,552,29.43,Bages,Interior,Manresa,30,Barcelona,21,72,25,16,57,18,37,129,43,209,118,91,0.5646,0.4354,0.177,0.6172,0.2057,7.1
1749,2020,Talarn,572,27.95,Pallars Jussà,Pre-Pirineu,Tremp,14,Lleida,23,332,47,25,127,41,48,459,88,595,402,193,0.6756,0.3244,0.0807,0.7714,0.1479,21.29
1750,2020,Talavera,791,30.11,Segarra,Interior,Cervera,21,Lleida,16,95,45,12,66,45,28,161,90,279,156,123,0.5591,0.4409,0.1004,0.5771,0.3226,9.27
1751,2020,"Tallada d'Empordà, la",20,16.56,Baix Empordà,Costal,"Bisbal d'Empordà, la",36,Girona,30,149,58,34,136,47,64,285,105,454,237,217,0.522,0.478,0.141,0.6278,0.2313,27.42
1752,2020,Taradell,623,26.48,Osona,Interior,Vic,50,Barcelona,573,2183,570,494,2117,703,1067,4300,1273,6640,3326,3314,0.5009,0.4991,0.1607,0.6476,0.1917,250.76
1753,2020,Tarragona,68,57.88,Tarragonès,Costal,Tarragona,22,Tarragona,10621,45483,10562,10212,45245,14373,20833,90728,24935,136496,66666,69830,0.4884,0.5116,0.1526,0.6647,0.1827,2358.26
1754,2020,Tàrrega,373,88.36,Urgell,Interior,Tàrrega,20,Lleida,1583,5875,1200,1481,5727,1579,3064,11602,2779,17445,8658,8787,0.4963,0.5037,0.1756,0.6651,0.1593,197.43
1755,2020,Tarrés,578,13.01,Garrigues,Interior,"Borges Blanques, les",24,Lleida,6,29,19,8,28,12,14,57,31,102,54,48,0.5294,0.4706,0.1373,0.5588,0.3039,7.84
1756,2020,Tarroja de Segarra,460,7.61,Segarra,Interior,Cervera,21,Lleida,11,57,31,17,51,21,28,108,52,188,99,89,0.5266,0.4734,0.1489,0.5745,0.2766,24.7
1757,2020,Tavèrnoles,537,18.76,Osona,Interior,Vic,50,Barcelona,28,105,33,29,92,35,57,197,68,322,166,156,0.5155,0.4845,0.177,0.6118,0.2112,17.16
1758,2020,Tavertet,869,32.49,Osona,Interior,Vic,50,Barcelona,3,31,18,4,31,18,7,62,36,105,52,53,0.4952,0.5048,0.0667,0.5905,0.3429,3.23
1759,2020,Teià,128,6.63,Maresme,Costal,Mataró,30,Barcelona,509,2047,597,426,2088,760,935,4135,1357,6427,3153,3274,0.4906,0.5094,0.1455,0.6434,0.2111,969.38
1760,2020,Térmens,208,27.54,Noguera,Interior,Balaguer,30,Lleida,82,470,136,82,393,197,164,863,333,1360,688,672,0.5059,0.4941,0.1206,0.6346,0.2449,49.38
1761,2020,Terrades,228,20.96,Alt Empordà,Costal,Figueres,68,Girona,18,116,32,27,108,37,45,224,69,338,166,172,0.4911,0.5089,0.1331,0.6627,0.2041,16.13
1762,2020,Terrassa,277,70.16,Vallès Occidental,Interior,Sabadell i Terrassa,23,Barcelona,19286,74717,15945,18136,73693,21850,37422,148410,37795,223627,109948,113679,0.4917,0.5083,0.1673,0.6636,0.169,3187.39
1763,2020,Tiana,136,7.95,Maresme,Costal,Mataró,30,Barcelona,726,2890,689,763,3062,815,1489,5952,1504,8945,4305,4640,0.4813,0.5187,0.1665,0.6654,0.1681,1125.16
1764,2020,Tírvia,991,8.5,Pallars Sobirà,Pirineu,Sort,15,Lleida,5,43,15,7,42,22,12,85,37,134,63,71,0.4701,0.5299,0.0896,0.6343,0.2761,15.76
1765,2020,Tiurana,387,15.86,Noguera,Interior,Balaguer,30,Lleida,3,22,9,4,29,10,7,51,19,77,34,43,0.4416,0.5584,0.0909,0.6623,0.2468,4.85
1766,2020,Tivenys,13,53.54,Baix Ebre,Costal,Tortosa,14,Tarragona,34,299,124,43,247,155,77,546,279,902,457,445,0.5067,0.4933,0.0854,0.6053,0.3093,16.85
1767,2020,Tivissa,309,209.43,Ribera d'Ebre,Interior,Móra d'Ebre,14,Tarragona,100,517,195,88,482,237,188,999,432,1619,812,807,0.5015,0.4985,0.1161,0.617,0.2668,7.73
1768,2020,Tona,596,16.54,Osona,Interior,Vic,50,Barcelona,660,2840,656,639,2727,834,1299,5567,1490,8356,4156,4200,0.4974,0.5026,0.1555,0.6662,0.1783,505.2
1769,2020,Torà,448,93.31,Segarra,Interior,Cervera,21,Lleida,81,422,124,75,380,155,156,802,279,1237,627,610,0.5069,0.4931,0.1261,0.6483,0.2255,13.26
1770,2020,Tordera,34,84.09,Maresme,Costal,Mataró,30,Barcelona,1543,5940,1387,1402,5626,1621,2945,11566,3008,17519,8870,8649,0.5063,0.4937,0.1681,0.6602,0.1717,208.34
1771,2020,Torelló,508,13.48,Osona,Interior,Vic,50,Barcelona,1124,4814,1233,1100,4515,1614,2224,9329,2847,14400,7171,7229,0.498,0.502,0.1544,0.6478,0.1977,1068.25
1772,2020,"Torms, els",476,13.75,Garrigues,Interior,"Borges Blanques, les",24,Lleida,7,46,21,2,36,26,9,82,47,138,74,64,0.5362,0.4638,0.0652,0.5942,0.3406,10.04
1773,2020,Tornabous,289,24.17,Urgell,Interior,Tàrrega,20,Lleida,55,286,99,52,220,110,107,506,209,822,440,382,0.5353,0.4647,0.1302,0.6156,0.2543,34.01
1774,2020,"Torre de Cabdella, la",1075,165.27,Pallars Jussà,Pre-Pirineu,Tremp,14,Lleida,31,255,95,30,212,136,61,467,231,759,381,378,0.502,0.498,0.0804,0.6153,0.3043,4.59
1775,2020,"Torre de Claramunt, la",363,15.02,Anoia,Interior,Igualada,33,Barcelona,306,1336,293,269,1220,317,575,2556,610,3741,1935,1806,0.5172,0.4828,0.1537,0.6832,0.1631,249.07
1776,2020,"Torre de Fontaubella, la",369,7.11,Priorat,Interior,Falset,23,Tarragona,12,36,21,7,35,20,19,71,41,131,69,62,0.5267,0.4733,0.145,0.542,0.313,18.42
1777,2020,"Torre de l'Espanyol, la",164,27.9,Ribera d'Ebre,Interior,Móra d'Ebre,14,Tarragona,32,199,77,38,174,81,70,373,158,601,308,293,0.5125,0.4875,0.1165,0.6206,0.2629,21.54
1778,2020,Torrebesses,287,27.45,Segrià,Costal,Lleida,38,Lleida,14,90,39,13,65,46,27,155,85,267,143,124,0.5356,0.4644,0.1011,0.5805,0.3184,9.73
1779,2020,Torredembarra,15,8.71,Tarragonès,Costal,Tarragona,22,Tarragona,1271,5428,1435,1230,5432,1771,2501,10860,3206,16567,8134,8433,0.491,0.509,0.151,0.6555,0.1935,1902.07
1780,2020,Torrefarrera,214,23.49,Segrià,Costal,Lleida,38,Lleida,464,1643,274,428,1562,323,892,3205,597,4694,2381,2313,0.5072,0.4928,0.19,0.6828,0.1272,199.83
1781,2020,Torrefeta i Florejacs,475,88.91,Segarra,Interior,Cervera,21,Lleida,35,215,76,31,166,84,66,381,160,607,326,281,0.5371,0.4629,0.1087,0.6277,0.2636,6.83
1782,2020,Torregrossa,232,40.52,Pla d'Urgell,Interior,Mollerussa,16,Lleida,149,764,230,139,613,284,288,1377,514,2179,1143,1036,0.5246,0.4754,0.1322,0.6319,0.2359,53.78
1783,2020,Torrelameu,201,10.93,Noguera,Interior,Balaguer,30,Lleida,44,322,77,42,169,81,86,491,158,735,443,292,0.6027,0.3973,0.117,0.668,0.215,67.25
1784,2020,Torrelavit,202,23.65,Alt Penedès,Interior,Vilafranca del Penedès,27,Barcelona,126,462,133,121,445,135,247,907,268,1422,721,701,0.507,0.493,0.1737,0.6378,0.1885,60.13
1785,2020,Torrelles de Foix,367,36.72,Alt Penedès,Interior,Vilafranca del Penedès,27,Barcelona,179,891,211,165,725,227,344,1616,438,2398,1281,1117,0.5342,0.4658,0.1435,0.6739,0.1827,65.31
1786,2020,Torrelles de Llobregat,126,13.56,Baix Llobregat,Costal,St. Feliu de Llobregat,30,Barcelona,542,2122,357,547,2071,434,1089,4193,791,6073,3021,3052,0.4974,0.5026,0.1793,0.6904,0.1302,447.86
1787,2020,Torrent,44,7.96,Baix Empordà,Costal,"Bisbal d'Empordà, la",36,Girona,9,59,19,13,46,18,22,105,37,164,87,77,0.5305,0.4695,0.1341,0.6402,0.2256,20.6
1788,2020,Torres de Segre,119,50.61,Segrià,Costal,Lleida,38,Lleida,136,888,204,146,757,235,282,1645,439,2366,1228,1138,0.519,0.481,0.1192,0.6953,0.1855,46.75
1789,2020,Torre-serona,197,5.89,Segrià,Costal,Lleida,38,Lleida,21,150,37,26,118,46,47,268,83,398,208,190,0.5226,0.4774,0.1181,0.6734,0.2085,67.57
1790,2020,Torroella de Fluvià,9,16.85,Alt Empordà,Costal,Figueres,68,Girona,49,260,58,49,228,59,98,488,117,703,367,336,0.522,0.478,0.1394,0.6942,0.1664,41.72
1791,2020,Torroella de Montgrí,31,65.93,Baix Empordà,Costal,"Bisbal d'Empordà, la",36,Girona,954,4004,1025,893,3805,1155,1847,7809,2180,11836,5983,5853,0.5055,0.4945,0.156,0.6598,0.1842,179.52
1792,2020,Torroja del Priorat,332,13.16,Priorat,Interior,Falset,23,Tarragona,9,52,24,4,37,26,13,89,50,152,85,67,0.5592,0.4408,0.0855,0.5855,0.3289,11.55
1793,2020,Tortellà,276,11.07,Garrotxa,Pre-Pirineu,Olot,21,Girona,51,253,87,68,257,102,119,510,189,818,391,427,0.478,0.522,0.1455,0.6235,0.2311,73.89
1794,2020,Tortosa,12,218.51,Baix Ebre,Costal,Tortosa,14,Tarragona,2594,11033,2967,2494,10407,3944,5088,21440,6911,33439,16594,16845,0.4962,0.5038,0.1522,0.6412,0.2067,153.03
1795,2020,Toses,1444,57.88,Ripollès,Pirineu,Ripoll,19,Girona,9,66,23,12,45,13,21,111,36,168,98,70,0.5833,0.4167,0.125,0.6607,0.2143,2.9
1796,2020,Tossa de Mar,5,38.58,Selva,Costal,Sta. Coloma de Farners,26,Girona,354,2051,522,380,1870,641,734,3921,1163,5818,2927,2891,0.5031,0.4969,0.1262,0.6739,0.1999,150.8
1797,2020,Tremp,468,302.82,Pallars Jussà,Pre-Pirineu,Tremp,14,Lleida,413,1920,562,399,1851,766,812,3771,1328,5911,2895,3016,0.4898,0.5102,0.1374,0.638,0.2247,19.52
1798,2020,Ullà,21,7.29,Baix Empordà,Costal,"Bisbal d'Empordà, la",36,Girona,118,446,84,107,336,86,225,782,170,1177,648,529,0.5506,0.4494,0.1912,0.6644,0.1444,161.45
1799,2020,Ullastrell,342,7.31,Vallès Occidental,Interior,Sabadell i Terrassa,23,Barcelona,215,705,133,204,669,163,419,1374,296,2089,1053,1036,0.5041,0.4959,0.2006,0.6577,0.1417,285.77
1800,2020,Ullastret,49,11.09,Baix Empordà,Costal,"Bisbal d'Empordà, la",36,Girona,18,89,31,25,79,32,43,168,63,274,138,136,0.5036,0.4964,0.1569,0.6131,0.2299,24.71
1801,2020,Ulldecona,133,126.88,Montsià,Costal,Amposta,12,Tarragona,487,2407,600,451,1878,702,938,4285,1302,6525,3494,3031,0.5355,0.4645,0.1438,0.6567,0.1995,51.43
1802,2020,Ulldemolins,650,38.17,Priorat,Interior,Falset,23,Tarragona,16,134,76,14,91,67,30,225,143,398,226,172,0.5678,0.4322,0.0754,0.5653,0.3593,10.43
1803,2020,Ultramort,30,4.35,Baix Empordà,Costal,"Bisbal d'Empordà, la",36,Girona,25,64,28,18,59,31,43,123,59,225,117,108,0.52,0.48,0.1911,0.5467,0.2622,51.72
1804,2020,Urús,1263,17.42,Cerdanya,Pirineu,Puigcerdà,17,Girona,8,73,15,8,67,25,16,140,40,196,96,100,0.4898,0.5102,0.0816,0.7143,0.2041,11.25
1805,2020,Vacarisses,382,40.7,Vallès Occidental,Interior,Sabadell i Terrassa,23,Barcelona,679,2413,408,591,2302,439,1270,4715,847,6832,3500,3332,0.5123,0.4877,0.1859,0.6901,0.124,167.86
1806,2020,"Vajol, la",546,4.71,Alt Empordà,Costal,Figueres,68,Girona,3,37,11,2,24,12,5,61,23,89,51,38,0.573,0.427,0.0562,0.6854,0.2584,18.9
1807,2020,"Vall d'en Bas, la",510,90.67,Garrotxa,Pre-Pirineu,Olot,21,Girona,270,998,300,225,961,339,495,1959,639,3093,1568,1525,0.507,0.493,0.16,0.6334,0.2066,34.11
1808,2020,"Vall de Bianya, la",367,93.62,Garrotxa,Pre-Pirineu,Olot,21,Girona,93,438,110,103,409,122,196,847,232,1275,641,634,0.5027,0.4973,0.1537,0.6643,0.182,13.62
1809,2020,"Vall de Boí, la",1111,219.49,Alta Ribagorça,Pirineu,"Pont de Suert, el",3,Lleida,68,378,97,68,336,72,136,714,169,1019,543,476,0.5329,0.4671,0.1335,0.7007,0.1658,4.64
1810,2020,Vall de Cardós,898,56.2,Pallars Sobirà,Pirineu,Sort,15,Lleida,16,133,40,23,94,44,39,227,84,350,189,161,0.54,0.46,0.1114,0.6486,0.24,6.23
1811,2020,Vallbona d'Anoia,289,6.45,Anoia,Interior,Igualada,33,Barcelona,110,465,128,77,428,149,187,893,277,1357,703,654,0.5181,0.4819,0.1378,0.6581,0.2041,210.39
1812,2020,Vallbona de les Monges,481,34.14,Urgell,Interior,Tàrrega,20,Lleida,6,85,36,11,55,50,17,140,86,243,127,116,0.5226,0.4774,0.07,0.5761,0.3539,7.12
1813,2020,Vallcebre,1123,27.99,Berguedà,Pre-Pirineu,Berga,31,Barcelona,4,94,42,10,64,35,14,158,77,249,140,109,0.5622,0.4378,0.0562,0.6345,0.3092,8.9
1814,2020,Vallclara,625,13.63,Conca de Barberà,Interior,Montblanc,22,Tarragona,6,34,12,4,23,9,10,57,21,88,52,36,0.5909,0.4091,0.1136,0.6477,0.2386,6.46
1815,2020,Vallfogona de Balaguer,235,26.97,Noguera,Interior,Balaguer,30,Lleida,168,615,168,164,604,187,332,1219,355,1906,951,955,0.499,0.501,0.1742,0.6396,0.1863,70.67
1816,2020,Vallfogona de Ripollès,956,39.2,Ripollès,Pirineu,Ripoll,19,Girona,11,65,31,7,52,30,18,117,61,196,107,89,0.5459,0.4541,0.0918,0.5969,0.3112,5.0
1817,2020,Vallfogona de Riucorb,573,10.94,Conca de Barberà,Interior,Montblanc,22,Tarragona,0,29,18,0,14,16,0,43,34,77,47,30,0.6104,0.3896,0.0,0.5584,0.4416,7.04
1818,2020,Vallgorguina,222,22.13,Vallès Oriental,Interior,Granollers,39,Barcelona,299,1040,174,287,999,189,586,2039,363,2988,1513,1475,0.5064,0.4936,0.1961,0.6824,0.1215,135.02
1819,2020,Vallirana,177,23.88,Baix Llobregat,Costal,St. Feliu de Llobregat,30,Barcelona,1303,5154,1234,1267,4959,1395,2570,10113,2629,15312,7691,7621,0.5023,0.4977,0.1678,0.6605,0.1717,641.21
1820,2020,Vall-llobrega,49,5.45,Baix Empordà,Costal,"Bisbal d'Empordà, la",36,Girona,78,320,53,76,309,61,154,629,114,897,451,446,0.5028,0.4972,0.1717,0.7012,0.1271,164.59
1821,2020,Vallmoll,161,16.68,Alt Camp,Interior,Valls,23,Tarragona,143,601,146,150,575,159,293,1176,305,1774,890,884,0.5017,0.4983,0.1652,0.6629,0.1719,106.35
1822,2020,Vallromanes,153,10.65,Vallès Oriental,Interior,Granollers,39,Barcelona,249,916,157,208,864,164,457,1780,321,2558,1322,1236,0.5168,0.4832,0.1787,0.6959,0.1255,240.19
1823,2020,Valls,215,55.28,Alt Camp,Interior,Valls,23,Tarragona,1946,8373,1967,1866,7766,2559,3812,16139,4526,24477,12286,12191,0.5019,0.4981,0.1557,0.6594,0.1849,442.78
1824,2020,"Valls d'Aguilar, les",669,123.81,Alt Urgell,Pirineu,"Seu d'Urgell, la",19,Lleida,9,88,43,6,67,32,15,155,75,245,140,105,0.5714,0.4286,0.0612,0.6327,0.3061,1.98
1825,2020,"Valls de Valira, les",740,171.25,Alt Urgell,Pirineu,"Seu d'Urgell, la",19,Lleida,53,275,76,45,251,84,98,526,160,784,404,380,0.5153,0.4847,0.125,0.6709,0.2041,4.58
1826,2020,Vandellòs i l'Hospitalet de l'Infant,281,102.67,Baix Camp,Costal,Reus,28,Tarragona,605,2191,508,533,2137,629,1138,4328,1137,6603,3304,3299,0.5004,0.4996,0.1723,0.6555,0.1722,64.31
1827,2020,"Vansa i Fórnols, la",989,106.08,Alt Urgell,Pirineu,"Seu d'Urgell, la",19,Lleida,2,53,23,3,45,23,5,98,46,149,78,71,0.5235,0.4765,0.0336,0.6577,0.3087,1.4
1828,2020,Veciana,564,38.9,Anoia,Interior,Igualada,33,Barcelona,17,48,30,14,42,24,31,90,54,175,95,80,0.5429,0.4571,0.1771,0.5143,0.3086,4.5
1829,2020,"Vendrell, el",49,36.8,Baix Penedès,Costal,"Vendrell, el",14,Tarragona,3160,12548,3344,3038,12358,3925,6198,24906,7269,38373,19052,19321,0.4965,0.5035,0.1615,0.6491,0.1894,1042.74
1830,2020,Ventalló,28,25.05,Alt Empordà,Costal,Figueres,68,Girona,72,270,86,63,262,93,135,532,179,846,428,418,0.5059,0.4941,0.1596,0.6288,0.2116,33.77
1831,2020,Verdú,434,35.79,Urgell,Interior,Tàrrega,20,Lleida,45,281,95,58,269,154,103,550,249,902,421,481,0.4667,0.5333,0.1142,0.6098,0.2761,25.2
1832,2020,Verges,23,9.7,Baix Empordà,Costal,"Bisbal d'Empordà, la",36,Girona,85,365,125,95,341,158,180,706,283,1169,575,594,0.4919,0.5081,0.154,0.6039,0.2421,120.52
1833,2020,Vespella de Gaià,191,18.04,Tarragonès,Costal,Tarragona,22,Tarragona,34,140,56,30,118,39,64,258,95,417,230,187,0.5516,0.4484,0.1535,0.6187,0.2278,23.12
1834,2020,Vic,484,30.58,Osona,Interior,Vic,50,Barcelona,4242,16880,2976,3941,15230,4361,8183,32110,7337,47630,24098,23532,0.5059,0.4941,0.1718,0.6742,0.154,1557.55
1835,2020,Vidrà,982,34.39,Osona,Interior,Vic,50,Barcelona,12,59,17,17,58,14,29,117,31,177,88,89,0.4972,0.5028,0.1638,0.661,0.1751,5.15
1836,2020,Vidreres,93,48.05,Selva,Costal,Sta. Coloma de Farners,26,Girona,634,2822,674,573,2522,726,1207,5344,1400,7951,4130,3821,0.5194,0.4806,0.1518,0.6721,0.1761,165.47
1837,2020,Vielha e Mijaran,974,211.74,Val d'Aran,Pirineu,Vielha,9,Lleida,407,2106,345,384,1964,405,791,4070,750,5611,2858,2753,0.5094,0.4906,0.141,0.7254,0.1337,26.5
1838,2020,Vilabella,254,18.19,Alt Camp,Interior,Valls,23,Tarragona,43,244,86,39,220,97,82,464,183,729,373,356,0.5117,0.4883,0.1125,0.6365,0.251,40.08
1839,2020,Vilabertran,19,2.29,Alt Empordà,Costal,Figueres,68,Girona,110,288,95,79,312,109,189,600,204,993,493,500,0.4965,0.5035,0.1903,0.6042,0.2054,433.62
1840,2020,Vilablareix,99,6.17,Gironès,Interior,Girona,27,Girona,306,981,230,283,1016,247,589,1997,477,3063,1517,1546,0.4953,0.5047,0.1923,0.652,0.1557,496.43
1841,2020,Vilada,757,22.34,Berguedà,Pre-Pirineu,Berga,31,Barcelona,20,131,70,12,112,74,32,243,144,419,221,198,0.5274,0.4726,0.0764,0.58,0.3437,18.76
1842,2020,Viladamat,13,11.73,Alt Empordà,Costal,Figueres,68,Girona,29,149,54,38,134,54,67,283,108,458,232,226,0.5066,0.4934,0.1463,0.6179,0.2358,39.05
1843,2020,Viladasens,96,15.74,Gironès,Interior,Girona,27,Girona,19,74,17,9,64,23,28,138,40,206,110,96,0.534,0.466,0.1359,0.6699,0.1942,13.09
1844,2020,Viladecans,18,20.4,Baix Llobregat,Costal,St. Feliu de Llobregat,30,Barcelona,5803,22550,4878,5438,22269,6259,11241,44819,11137,67197,33231,33966,0.4945,0.5055,0.1673,0.667,0.1657,3293.97
1845,2020,Viladecavalls,274,20.09,Vallès Occidental,Interior,Sabadell i Terrassa,23,Barcelona,616,2605,539,584,2619,582,1200,5224,1121,7545,3760,3785,0.4983,0.5017,0.159,0.6924,0.1486,375.56
1846,2020,Vilademuls,120,61.54,Pla de l'Estany,Interior,Banyoles,11,Girona,79,273,79,73,257,74,152,530,153,835,431,404,0.5162,0.4838,0.182,0.6347,0.1832,13.57
1847,2020,Viladrau,821,50.73,Osona,Interior,Vic,50,Barcelona,76,346,86,83,340,116,159,686,202,1047,508,539,0.4852,0.5148,0.1519,0.6552,0.1929,20.64
1848,2020,Vilafant,54,8.36,Alt Empordà,Costal,Figueres,68,Girona,459,1741,460,398,1810,553,857,3551,1013,5421,2660,2761,0.4907,0.5093,0.1581,0.655,0.1869,648.44
1849,2020,Vilafranca del Penedès,223,19.65,Alt Penedès,Interior,Vilafranca del Penedès,27,Barcelona,3533,12950,3033,3324,13171,4143,6857,26121,7176,40154,19516,20638,0.486,0.514,0.1708,0.6505,0.1787,2043.46
1850,2020,Vilagrassa,355,19.87,Urgell,Interior,Tàrrega,20,Lleida,49,198,47,38,177,51,87,375,98,560,294,266,0.525,0.475,0.1554,0.6696,0.175,28.18
1851,2020,Vilajuïga,31,13.13,Alt Empordà,Costal,Figueres,68,Girona,81,387,90,76,383,99,157,770,189,1116,558,558,0.5,0.5,0.1407,0.69,0.1694,85.0
1852,2020,Vilalba dels Arcs,450,67.25,Terra Alta,Interior,Gandesa,12,Tarragona,30,192,91,38,160,110,68,352,201,621,313,308,0.504,0.496,0.1095,0.5668,0.3237,9.23
1853,2020,Vilalba Sasserra,200,6.05,Vallès Oriental,Interior,Granollers,39,Barcelona,66,268,50,58,238,73,124,506,123,753,384,369,0.51,0.49,0.1647,0.672,0.1633,124.46
1854,2020,Vilaller,981,59.23,Alta Ribagorça,Pirineu,"Pont de Suert, el",3,Lleida,41,193,57,23,159,76,64,352,133,549,291,258,0.5301,0.4699,0.1166,0.6412,0.2423,9.27
1855,2020,Vilallonga de Ter,1067,64.2,Ripollès,Pirineu,Ripoll,19,Girona,18,146,49,22,114,49,40,260,98,398,213,185,0.5352,0.4648,0.1005,0.6533,0.2462,6.2
1856,2020,Vilallonga del Camp,124,9.04,Tarragonès,Costal,Tarragona,22,Tarragona,272,794,157,238,761,183,510,1555,340,2405,1223,1182,0.5085,0.4915,0.2121,0.6466,0.1414,266.04
1857,2020,Vilamacolum,5,5.57,Alt Empordà,Costal,Figueres,68,Girona,31,147,33,32,94,40,63,241,73,377,211,166,0.5597,0.4403,0.1671,0.6393,0.1936,67.68
1858,2020,Vilamalla,45,8.77,Alt Empordà,Costal,Figueres,68,Girona,96,389,101,98,367,110,194,756,211,1161,586,575,0.5047,0.4953,0.1671,0.6512,0.1817,132.38
1859,2020,Vilamaniscle,169,5.46,Alt Empordà,Costal,Figueres,68,Girona,14,79,28,13,58,20,27,137,48,212,121,91,0.5708,0.4292,0.1274,0.6462,0.2264,38.83
1860,2020,Vilamòs,1255,15.44,Val d'Aran,Pirineu,Vielha,9,Lleida,9,73,13,10,60,13,19,133,26,178,95,83,0.5337,0.4663,0.1067,0.7472,0.1461,11.53
1861,2020,Vilanant,98,16.87,Alt Empordà,Costal,Figueres,68,Girona,32,131,31,33,124,35,65,255,66,386,194,192,0.5026,0.4974,0.1684,0.6606,0.171,22.88
1862,2020,Vilanova d'Escornalbou,226,17.16,Baix Camp,Costal,Reus,28,Tarragona,40,193,63,46,171,52,86,364,115,565,296,269,0.5239,0.4761,0.1522,0.6442,0.2035,32.93
1863,2020,Vilanova de Bellpuig,290,13.98,Pla d'Urgell,Interior,Mollerussa,16,Lleida,86,358,156,94,288,201,180,646,357,1183,600,583,0.5072,0.4928,0.1522,0.5461,0.3018,84.62
1864,2020,Vilanova de l'Aguda,409,53.68,Noguera,Interior,Balaguer,30,Lleida,8,58,32,3,63,36,11,121,68,200,98,102,0.49,0.51,0.055,0.605,0.34,3.73
1865,2020,Vilanova de la Barca,195,21.55,Segrià,Costal,Lleida,38,Lleida,69,421,102,58,302,136,127,723,238,1088,592,496,0.5441,0.4559,0.1167,0.6645,0.2188,50.49
1866,2020,Vilanova de Meià,633,105.24,Noguera,Interior,Balaguer,30,Lleida,22,153,74,17,87,62,39,240,136,415,249,166,0.6,0.4,0.094,0.5783,0.3277,3.94
1867,2020,Vilanova de Prades,893,21.51,Conca de Barberà,Interior,Montblanc,22,Tarragona,5,37,14,8,37,6,13,74,20,107,56,51,0.5234,0.4766,0.1215,0.6916,0.1869,4.97
1868,2020,Vilanova de Sau,558,58.84,Osona,Interior,Vic,50,Barcelona,23,82,43,15,106,43,38,188,86,312,148,164,0.4744,0.5256,0.1218,0.6026,0.2756,5.3
1869,2020,Vilanova de Segrià,255,8.51,Segrià,Costal,Lleida,38,Lleida,78,360,91,67,288,101,145,648,192,985,529,456,0.5371,0.4629,0.1472,0.6579,0.1949,115.75
1870,2020,Vilanova del Camí,302,10.28,Anoia,Interior,Igualada,33,Barcelona,1081,4255,956,1080,4063,1161,2161,8318,2117,12596,6292,6304,0.4995,0.5005,0.1716,0.6604,0.1681,1225.29
1871,2020,Vilanova del Vallès,91,15.2,Vallès Oriental,Interior,Granollers,39,Barcelona,577,1883,321,522,1834,366,1099,3717,687,5503,2781,2722,0.5054,0.4946,0.1997,0.6754,0.1248,362.04
1872,2020,Vilanova i la Geltrú,22,33.99,Garraf,Costal,Vilanova i la Geltrú,6,Barcelona,5006,22120,5626,4770,22695,7516,9776,44815,13142,67733,32752,34981,0.4835,0.5165,0.1443,0.6616,0.194,1992.73
1873,2020,Vilaplana,366,23.2,Baix Camp,Costal,Reus,28,Tarragona,30,209,58,28,171,59,58,380,117,555,297,258,0.5351,0.4649,0.1045,0.6847,0.2108,23.92
1874,2020,Vila-rodona,259,33.11,Alt Camp,Interior,Valls,23,Tarragona,101,465,111,95,373,131,196,838,242,1276,677,599,0.5306,0.4694,0.1536,0.6567,0.1897,38.54
1875,2020,Vila-sacra,16,6.03,Alt Empordà,Costal,Figueres,68,Girona,70,242,65,81,223,77,151,465,142,758,377,381,0.4974,0.5026,0.1992,0.6135,0.1873,125.7
1876,2020,Vila-sana,249,19.1,Pla d'Urgell,Interior,Mollerussa,16,Lleida,66,255,52,52,227,82,118,482,134,734,373,361,0.5082,0.4918,0.1608,0.6567,0.1826,38.43
1877,2020,Vila-seca,45,21.64,Tarragonès,Costal,Tarragona,22,Tarragona,2154,7734,1429,2043,7526,1669,4197,15260,3098,22555,11317,11238,0.5018,0.4982,0.1861,0.6766,0.1374,1042.28
1878,2020,Vilassar de Dalt,142,8.86,Maresme,Costal,Mataró,30,Barcelona,679,2985,800,670,2974,964,1349,5959,1764,9072,4464,4608,0.4921,0.5079,0.1487,0.6569,0.1944,1023.93
1879,2020,Vilassar de Mar,10,4.0,Maresme,Costal,Mataró,30,Barcelona,1702,6681,1803,1626,6906,2317,3328,13587,4120,21035,10186,10849,0.4842,0.5158,0.1582,0.6459,0.1959,5258.75
1880,2020,Vilaür,65,5.49,Alt Empordà,Costal,Figueres,68,Girona,20,43,17,13,52,13,33,95,30,158,80,78,0.5063,0.4937,0.2089,0.6013,0.1899,28.78
1881,2020,Vilaverd,269,12.61,Conca de Barberà,Interior,Montblanc,22,Tarragona,30,166,41,27,133,46,57,299,87,443,237,206,0.535,0.465,0.1287,0.6749,0.1964,35.13
1882,2020,"Vilella Alta, la",327,5.15,Priorat,Interior,Falset,23,Tarragona,8,45,19,11,33,17,19,78,36,133,72,61,0.5414,0.4586,0.1429,0.5865,0.2707,25.83
1883,2020,"Vilella Baixa, la",218,5.62,Priorat,Interior,Falset,23,Tarragona,14,71,25,10,60,24,24,131,49,204,110,94,0.5392,0.4608,0.1176,0.6422,0.2402,36.3
1884,2020,Vilobí d'Onyar,122,32.59,Selva,Costal,Sta. Coloma de Farners,26,Girona,286,1180,266,276,1025,300,562,2205,566,3333,1732,1601,0.5197,0.4803,0.1686,0.6616,0.1698,102.27
1885,2020,Vilobí del Penedès,286,9.34,Alt Penedès,Interior,Vilafranca del Penedès,27,Barcelona,99,362,109,84,323,125,183,685,234,1102,570,532,0.5172,0.4828,0.1661,0.6216,0.2123,117.99
1886,2020,Vilopriu,82,16.38,Baix Empordà,Costal,"Bisbal d'Empordà, la",36,Girona,16,64,29,13,53,29,29,117,58,204,109,95,0.5343,0.4657,0.1422,0.5735,0.2843,12.45
1887,2020,"Vilosell, el",665,18.88,Garrigues,Interior,"Borges Blanques, les",24,Lleida,5,50,34,7,46,31,12,96,65,173,89,84,0.5145,0.4855,0.0694,0.5549,0.3757,9.16
1888,2020,Vimbodí i Poblet,496,66.09,Conca de Barberà,Interior,Montblanc,22,Tarragona,49,304,125,34,239,139,83,543,264,890,478,412,0.5371,0.4629,0.0933,0.6101,0.2966,13.47
1889,2020,Vinaixa,479,37.59,Garrigues,Interior,"Borges Blanques, les",24,Lleida,30,137,68,14,125,76,44,262,144,450,235,215,0.5222,0.4778,0.0978,0.5822,0.32,11.97
1890,2020,Vinebre,34,26.44,Ribera d'Ebre,Interior,Móra d'Ebre,14,Tarragona,40,132,43,24,131,55,64,263,98,425,215,210,0.5059,0.4941,0.1506,0.6188,0.2306,16.07
1891,2020,Vinyols i els Arcs,95,10.83,Baix Camp,Costal,Reus,28,Tarragona,186,736,191,185,669,157,371,1405,348,2124,1113,1011,0.524,0.476,0.1747,0.6615,0.1638,196.12
1892,2020,Viver i Serrateix,729,66.8,Berguedà,Pre-Pirineu,Berga,31,Barcelona,13,53,22,14,45,25,27,98,47,172,88,84,0.5116,0.4884,0.157,0.5698,0.2733,2.57
1893,2020,Xerta,12,32.39,Baix Ebre,Costal,Tortosa,14,Tarragona,55,366,148,61,331,193,116,697,341,1154,569,585,0.4931,0.5069,0.1005,0.604,0.2955,35.63
